game,positive_user_reviews,negative_user_reviews,mixed_user_reviews,total_user_reviews,polarization
GrimGrimoire,2466,317,7,2790,0.9974910394265233
Crystar,2161,115,12,2288,0.9947552447552448
Monster of the Deep: Final Fantasy XV,162,25,1,188,0.9946808510638298
After Burner Climax,1102,184,8,1294,0.9938176197836167
Diaries of a Spaceport Janitor,2964,382,21,3367,0.9937629937629938
Madden NFL 21,141,7121,50,7312,0.9931619256017505
Mark McMorris Infinite Air,110,29,1,140,0.9928571428571429
Day One : Garry's Incident,133,1516,12,1661,0.9927754364840458
Resident Evil 7: biohazard - Gold Edition,126,10,1,137,0.9927007299270073
Last Year,96,39,1,136,0.9926470588235294
Sasel RPG,48,84,1,133,0.9924812030075187
What Happened,175,65,2,242,0.9917355371900827
Left Alive,2723,370,30,3123,0.9903938520653218
Mega Man Battle Network Legacy Collection Vol. 1,41,57,1,99,0.98989898989899
World of Warcraft Classic: Burning Crusade Classic,35,443,5,483,0.989648033126294
DOOM: Bloodfall,73,14,1,88,0.9886363636363636
Guise of the Wolf,24,237,3,264,0.9886363636363636
Crisis Core: Final Fantasy VII Reunion,5025,1176,75,6276,0.9880497131931166
Rugby World Cup 2015,22,60,1,83,0.9879518072289156
Metal Gear Solid: The Legacy Collection,291,26,4,321,0.9875389408099688
Tears to Tiara II: Heir of the Overlord,64,13,1,78,0.9871794871794872
Resident Evil (Remake),1936,48,26,2010,0.9870646766169154
Torrente,62,88,2,152,0.9868421052631579
Erzurum,15,208,3,226,0.9867256637168141
RollerCoaster Tycoon 2: Triple Thrill Pack,56,17,1,74,0.9864864864864865
Fallen Legion: Sins of an Empire,129,16,2,147,0.9863945578231292
Under Night In-Birth Exe:Late[st],63,9,1,73,0.9863013698630136
Limbo of the Lost,14,58,1,73,0.9863013698630136
Calculator,504,58,8,570,0.9859649122807017
Skull Island: Rise of Kong,52,86,2,140,0.9857142857142858
Shin Megami Tensei: Devil Survivor 2 Record Breaker,138,131,4,273,0.9853479853479854
Basement Crawl,15,51,1,67,0.9850746268656716
The Legend of Zelda Collector's Edition,183,14,3,200,0.985
Just Shapes & Beats,114,16,2,132,0.9848484848484849
Whiteboyz Wit Attitude: The Pursuit of Money,113,14,2,129,0.9844961240310077
Air Control (2013),9,54,1,64,0.984375
Populous: The Beginning,59,4,1,64,0.984375
Wild Hearts,1198,235,23,1456,0.9842032967032966
Space Rangers,57,4,1,62,0.9838709677419355
Ready or Not,55,6,1,62,0.9838709677419355
Hot Pixel,35,25,1,61,0.9836065573770492
Heroes of Might and Magic III: Armageddon's Blade,115,5,2,122,0.9836065573770492
Bloodborne: Complete Edition,501,35,9,545,0.9834862385321101
Out of the Park Baseball 15,42,16,1,59,0.9830508474576272
The Witcher 3: Wild Hunt - Blood and Wine,6247,460,116,6823,0.9829986809321413
The House in Fata Morgana - Dreams of the Revenants Edition -,743,120,15,878,0.9829157175398633
Skies of Arcadia,206,23,4,233,0.9828326180257511
Lunar 2: Eternal Blue,48,6,1,55,0.9818181818181818
Zone of the Enders: The 2nd Runner MARS,43,11,1,55,0.9818181818181818
Pokemon Shield + Pokemon Shield Expansion Pass,68,39,2,109,0.981651376146789
World of Warcraft: Wrath of the Lich King Classic,12,94,2,108,0.9814814814814815
Platinum Demo: Final Fantasy XV,290,27,6,323,0.9814241486068112
Shin Megami Tensei: Devil Summoner 2: Raidou Kuzunoha vs. King Abaddon,83,127,4,214,0.9813084112149533
Fatal Frame: Mask of the Lunar Eclipse,1698,234,37,1969,0.9812087353986796
Shin Megami Tensei: Devil Survivor,118,140,5,263,0.9809885931558935
Tom Clancy's The Division 2: Warlords of New York,232,1981,43,2256,0.9809397163120568
Might and Magic VII: For Blood and Honor,48,3,1,52,0.9807692307692307
Final Fantasy XV: Episode Ignis,428,29,9,466,0.98068669527897
The Witcher 3: Wild Hunt - Hearts of Stone,5769,395,122,6286,0.9805917912822144
Playboy: The Mansion,109,91,4,204,0.9803921568627451
Soda Drinker Pro,124,26,3,153,0.9803921568627451
Grandia HD Collection,39,11,1,51,0.9803921568627451
Muv-Luv Alternative,44,6,1,51,0.9803921568627451
Heroes of Might and Magic III: The Shadow of Death,142,8,3,153,0.9803921568627451
MADiSON,1108,235,27,1370,0.9802919708029197
IL-2 Sturmovik: 1946,91,8,2,101,0.9801980198019802
OpenTTD,45,4,1,50,0.98
Final Fantasy XIV: Shadowbringers,1900,157,42,2099,0.9799904716531682
Middle-earth: Shadow of War - Definitive Edition,40,8,1,49,0.9795918367346939
Blood Bowl III,4,44,1,49,0.9795918367346939
The Quiet Man,42,197,5,244,0.9795081967213115
Yo-kai Watch 3,83,12,2,97,0.979381443298969
Ghost Trick: Phantom Detective,1848,140,42,2030,0.9793103448275862
Bayonetta & Vanquish,1230,44,27,1301,0.9792467332820907
Kingdom Hearts: The Story So Far,43,4,1,48,0.9791666666666666
Alone in the Dark: Illumination,9,132,3,144,0.9791666666666666
Tonight We Riot,33,14,1,48,0.9791666666666666
Silent Hill 2 (2001),1429,201,35,1665,0.978978978978979
Ghostbusters,85,373,10,468,0.9786324786324786
Metal Gear Solid 3: Subsistence,645,133,17,795,0.9786163522012579
Astro Bot Rescue Mission,504,44,12,560,0.9785714285714285
Half-Life: Alyx,2620,180,62,2862,0.9783368273934312
Shin Megami Tensei: Digital Devil Saga 2,96,129,5,230,0.9782608695652174
Ride to Hell: Retribution,129,1154,29,1312,0.9778963414634146
Metroid Prime Trilogy,453,33,11,497,0.9778672032193159
Grand Theft Auto: The Trilogy - The Definitive Edition,676,13112,313,14101,0.9778029926955535
Road Rage,6,38,1,45,0.9777777777777777
Steins;Gate,629,67,16,712,0.9775280898876404
Ghost of Tsushima: Legends,370,105,11,486,0.977366255144033
Making History II: The War of the World,34,9,1,44,0.9772727272727273
Horse Racing,15,28,1,44,0.9772727272727273
Agatha Christie - Murder on the Orient Express,39,4,1,44,0.9772727272727273
Phantasy Star Online 2: New Genesis,11,32,1,44,0.9772727272727273
Assassin's Creed: Ezio Trilogy,36,7,1,44,0.9772727272727273
MO:Astray,37,6,1,44,0.9772727272727273
Dynasty Warriors 9,1282,178,34,1494,0.9772423025435074
Bloodborne: The Old Hunters,2098,201,54,2353,0.9770505737356566
DOOM: Hell Followed,71,14,2,87,0.9770114942528736
Inazuma Eleven 2: Blizzard,37,5,1,43,0.9767441860465116
Laxius Force - Heroes Never Die,38,4,1,43,0.9767441860465116
Out of the Park Baseball 2007,55,446,12,513,0.9766081871345029
LostWinds: Winter of the Melodias,30,137,4,171,0.9766081871345029
Shin Megami Tensei: Strange Journey Redux,145,145,7,297,0.9764309764309764
Mario Kart 8 Deluxe: Booster Course Pass - Wave 4,35,6,1,42,0.9761904761904762
Ghostship Aftermath,25,16,1,42,0.9761904761904762
Growlanser: Heritage of War,34,6,1,41,0.975609756097561
The Underground Man,273,45,8,326,0.9754601226993865
Balan Wonderworld,693,558,32,1283,0.9750584567420109
Soldiers: Heroes of World War II,34,5,1,40,0.975
Dominions 4: Thrones of Ascension,35,4,1,40,0.975
Blues and Bullets - Episode 2: Shaking The Hive,19,20,1,40,0.975
Resident Evil 4,7692,2490,262,10444,0.9749138261202605
The Witcher 3: Wild Hunt,43962,3222,1216,48400,0.9748760330578512
Mario Kart 8 DLC Pack 1,362,63,11,436,0.9747706422018348
The Elder Scrolls Online: Tamriel Unlimited - The Imperial City,156,37,5,198,0.9747474747474747
Dungeon Keeper,147,7,4,158,0.9746835443037974
Suikoden II,284,20,8,312,0.9743589743589743
Vangers: One for the Road,34,4,1,39,0.9743589743589743
Shenmue,309,27,9,345,0.9739130434782609
Freedom Finger,97,15,3,115,0.9739130434782609
Starcraft: Brood War,356,15,10,381,0.973753280839895
Mad Rat Dead,31,6,1,38,0.9736842105263158
Loading Human: Chapter 1,24,13,1,38,0.9736842105263158
Elf Bowling 1 & 2,8,29,1,38,0.9736842105263158
The Evil Within: The Assignment,993,69,29,1091,0.9734188817598534
Fatal Frame: Maiden of Black Water,1575,292,51,1918,0.9734098018769551
Big Bash Boom,58,15,2,75,0.9733333333333334
ESPN NFL 2K5,89,20,3,112,0.9732142857142857
Shenmue II,131,14,4,149,0.9731543624161074
Kingdom Hearts: All-in-One Package,66,6,2,74,0.972972972972973
Shadow Harvest: Phantom Ops,5,31,1,37,0.972972972972973
Blood: Fresh Supply,34,2,1,37,0.972972972972973
Madden NFL 22,38,1364,39,1441,0.9729354614850798
Blue Reflection: Second Light,185,30,6,221,0.9728506787330317
God of War Saga,99,8,3,110,0.9727272727272728
Casey Powell Lacrosse 16,55,16,2,73,0.9726027397260274
Legends of Pegasus,6,100,3,109,0.9724770642201835
Firewall Ultra,151,201,10,362,0.9723756906077348
2064: Read Only Memories,228,440,19,687,0.9723435225618632
Metal Gear Solid,1830,273,60,2163,0.9722607489597781
Sense: A Cyberpunk Ghost Story,20,15,1,36,0.9722222222222222
TrackMania United Forever,31,4,1,36,0.9722222222222222
X-COM: UFO Defense,34,1,1,36,0.9722222222222222
Paper Mario: The Thousand-Year Door (2004),589,38,18,645,0.9720930232558139
HYPERCHARGE: Unboxed,92,12,3,107,0.9719626168224299
Fighter Within,50,158,6,214,0.9719626168224299
Etrian Odyssey IV: Legends of the Titan,150,23,5,178,0.9719101123595506
Bad Rats: The Rats Revenge,100,72,5,177,0.9717514124293786
OlliOlli World: Finding the Flowzone,26,8,1,35,0.9714285714285714
Xenogears,351,22,11,384,0.9713541666666666
Kid A MNESIA Exhibition,57,10,2,69,0.9710144927536232
Hearthstone: Heroes of Warcraft - Saviors of Uldum,4,29,1,34,0.9705882352941176
Madden NFL 24,27,303,10,340,0.9705882352941176
Soldner: Secret Wars,23,10,1,34,0.9705882352941176
The Angry Birds Movie 2 VR: Under Pressure,27,6,1,34,0.9705882352941176
Dragon Ball: Evolution,7,59,2,68,0.9705882352941176
Z.H.P. Unlosing Ranger vs Darkdeath Evilman,1043,40,33,1116,0.9704301075268817
Shin Megami Tensei: Strange Journey,126,133,8,267,0.9700374531835206
EverQuest: The Ruins of Kunark,28,4,1,33,0.9696969696969697
Twin Breaker: A Sacred Symbols Adventure,52,12,2,66,0.9696969696969697
Super Mega Baseball 4,20,12,1,33,0.9696969696969697
Game Party Champions,9,23,1,33,0.9696969696969697
Out of the Park Baseball 14,53,11,2,66,0.9696969696969697
Motorbike,3,29,1,33,0.9696969696969697
RollerCoaster Tycoon: Loopy Landscapes,25,7,1,33,0.9696969696969697
Mineirinho Director's Cut,18,14,1,33,0.9696969696969697
Mutant Football League,51,12,2,65,0.9692307692307692
Commandos 2 HD Remaster,17,77,3,97,0.9690721649484536
Heroes of Might and Magic III,894,39,30,963,0.9688473520249221
DOOM Classic Complete,27,4,1,32,0.96875
Baten Kaitos Origins,27,4,1,32,0.96875
Guilty Gear XX Accent Core,28,3,1,32,0.96875
Pocket Card Jockey,26,5,1,32,0.96875
Dark Raid,4,27,1,32,0.96875
Mega Man Zero 3,53,9,2,64,0.96875
Unreal,117,7,4,128,0.96875
Aquaman: Battle for Atlantis,5,26,1,32,0.96875
Call of Duty: Black Ops III - Eclipse,10,21,1,32,0.96875
Space Rangers 2: Rise of the Dominators,248,27,9,284,0.9683098591549296
Ghost of Tsushima: Director's Cut,2084,603,89,2776,0.9679394812680115
Red Matter,24,6,1,31,0.967741935483871
Linelight,22,8,1,31,0.967741935483871
Star Wars: Knights of the Old Republic Collection,27,3,1,31,0.967741935483871
Space Rangers 2: Reboot,55,5,2,62,0.967741935483871
Harvest Moon: Friends of Mineral Town,45,15,2,62,0.967741935483871
Giana Sisters: Dream Runners,14,16,1,31,0.967741935483871
The Banner Saga Trilogy: Bonus Edition,25,5,1,31,0.967741935483871
Shin Megami Tensei Online: Imagine,7,53,2,62,0.967741935483871
Umbrella Corps,40,258,10,308,0.9675324675324676
Hi-Fi Rush,4177,428,155,4760,0.967436974789916
Atelier Sophie 2: The Alchemist of the Mysterious Dream,348,37,13,398,0.9673366834170855
Coaster Crazy Deluxe,6,112,4,122,0.9672131147540983
Meme Run,22,37,2,61,0.9672131147540983
Pokemon Scarlet / Pokemon Violet Dual Pack Steelbook Edition,114,33,5,152,0.9671052631578947
Oreshika: Tainted Bloodlines,73,15,3,91,0.967032967032967
Metroid Prime,1280,97,47,1424,0.9669943820224719
The Last of Us Remastered,18458,890,665,20013,0.9667715984610004
Mary Skelter: Nightmares,53,5,2,60,0.9666666666666667
Out of Ammo,20,9,1,30,0.9666666666666667
Vanguard Bandits,26,3,1,30,0.9666666666666667
A Rose in the Twilight,25,4,1,30,0.9666666666666667
The Curious Tale of the Stolen Pets,22,7,1,30,0.9666666666666667
Dragon Saga,25,4,1,30,0.9666666666666667
Re:Turn - One Way Trip,24,5,1,30,0.9666666666666667
Baldur's Gate 3,14143,1494,546,16183,0.9662608910585182
Final Fantasy XIV: Heavensward,1777,141,67,1985,0.9662468513853905
My Friend Peppa Pig,447,68,18,533,0.9662288930581614
Jagged Alliance 2,159,12,6,177,0.9661016949152542
Mega Man Zero 2,48,9,2,59,0.9661016949152542
Dino Crisis 2,684,26,25,735,0.9659863945578231
Paper Mario,462,20,17,499,0.9659318637274549
Superliminal,3193,167,119,3479,0.96579476861167
King Arthur's Gold,50,6,2,58,0.9655172413793104
Zumba Fitness World Party,35,21,2,58,0.9655172413793104
Super Mega Space Blaster Special,74,9,3,86,0.9651162790697675
Resident Evil Code: Veronica,393,21,15,429,0.965034965034965
Age of Empires IV: Anniversary Edition,52,3,2,57,0.9649122807017544
The Sims 4: Star Wars - Journey to Batuu,3,52,2,57,0.9649122807017544
Last Train Home,42,13,2,57,0.9649122807017544
Ar tonelico II: Melody of Metafalica,47,8,2,57,0.9649122807017544
Gothic II,1159,71,45,1275,0.9647058823529412
The Legend of Zelda: The Wind Waker HD,1307,77,51,1435,0.9644599303135889
RollerCoaster Tycoon World,11,70,3,84,0.9642857142857143
Golden Sun: The Lost Age,146,16,6,168,0.9642857142857143
Yoshi's Island: Super Mario Advance 3,210,6,8,224,0.9642857142857143
Chrono Trigger,817,68,33,918,0.9640522875816994
Clannad,94,13,4,111,0.963963963963964
Pokemon Sword + Pokemon Sword Expansion Pass,70,37,4,111,0.963963963963964
Death's Gambit: Afterlife,114,19,5,138,0.9637681159420289
Resident Evil,1939,25,74,2038,0.9636898920510304
Persona 4 Golden,2836,295,118,3249,0.9636811326562019
Call of Duty: Modern Warfare 3 - Defiance,31,234,10,275,0.9636363636363636
King's Quest Chapter 3: Once Upon a Climb,37,16,2,55,0.9636363636363636
SOCOM II: U.S. Navy SEALs,47,6,2,55,0.9636363636363636
Castlevania: Symphony of the Night,920,58,37,1015,0.9635467980295567
Shin Megami Tensei: Persona 3,242,153,15,410,0.9634146341463414
Pathologic,70,9,3,82,0.9634146341463414
Dino Dini's Kick Off Revival,29,50,3,82,0.9634146341463414
Pizza Tower,220,16,9,245,0.963265306122449
Fast & Furious: Showdown,32,256,11,299,0.9632107023411371
Depression Quest,36,251,11,298,0.9630872483221476
Fallout 2,1493,72,60,1625,0.963076923076923
Persona 5,5131,778,227,6136,0.9630052151238592
The Last of Us,13479,780,548,14807,0.9629904774768691
Kirby's Dream Collection: Special Edition,50,2,2,54,0.9629629629629629
The Crew: Wild Run Edition,37,15,2,54,0.9629629629629629
The Lord of the Rings - Gollum,56,537,23,616,0.9626623376623377
Ace Combat 04: Shattered Skies,92,11,4,107,0.9626168224299065
Final Fantasy XV - Multiplayer Expansion: Comrades,347,39,15,401,0.9625935162094763
Victoria II: Heart of Darkness,71,6,3,80,0.9625
Resident Evil 4: Separate Ways,273,9,11,293,0.962457337883959
Factorio,622,70,27,719,0.9624478442280946
The Binding of Isaac: Repentance,106,22,5,133,0.9624060150375939
Rambo: The Video Game,67,494,22,583,0.9622641509433962
Front Mission 1st Remake,27,24,2,53,0.9622641509433962
Baroque,43,8,2,53,0.9622641509433962
Metal Gear Solid V: The Definitive Experience,114,13,5,132,0.9621212121212122
The Legend of Heroes: Trails of Cold Steel IV - The End of Saga,179,24,8,211,0.9620853080568721
Mega Man Battle Network Legacy Collection,121,81,8,210,0.9619047619047619
Babylon's Fall,46,306,14,366,0.9617486338797814
Pokemon Mystery Dungeon: Explorers of Sky,405,22,17,444,0.9617117117117117
Ghost of Tsushima: Iki Island,612,116,29,757,0.9616908850726552
Chants of Sennaar,45,5,2,52,0.9615384615384616
Mario Kart 8 DLC Pack 2,274,51,13,338,0.9615384615384616
Tetris (2010),42,8,2,52,0.9615384615384616
Omori,438,36,19,493,0.9614604462474645
God of War,23697,1528,1016,26241,0.9612819633398118
Resident Evil: Resistance,629,209,34,872,0.9610091743119266
Ghost of Tsushima,19998,952,852,21802,0.9609210164205119
TrackMania 2 Valley,40,9,2,51,0.9607843137254902
Super Smash Bros. Melee,844,36,36,916,0.9606986899563319
Bloodborne,12061,954,534,13549,0.9605874972322681
Might and Magic VI: The Mandate of Heaven,69,4,3,76,0.9605263157894737
The Persistence VR,60,13,3,76,0.9605263157894737
Super Mario Galaxy,3133,141,135,3409,0.9603989439718392
Age of Wonders,94,3,4,101,0.9603960396039604
Hunt Down The Freeman,47,50,4,101,0.9603960396039604
The Elder Scrolls III: Morrowind - Game of the Year Edition,238,28,11,277,0.9602888086642599
World of Warcraft: Shadowlands,567,1934,104,2605,0.9600767754318618
Marvel's Spider-Man - Game of the Year Edition,90,6,4,100,0.96
Artifact,111,489,25,625,0.96
Xenoblade Chronicles 3: Expansion Pass Wave 4 - Future Redeemed,307,29,14,350,0.96
Europa Universalis III: Heir to the Throne,44,4,2,50,0.96
Final Fantasy VII,3000,321,139,3460,0.9598265895953757
Dodgeball Academia,158,33,8,199,0.9597989949748744
It Takes Two,2705,203,122,3030,0.9597359735973597
Vanquish,4612,165,201,4978,0.9596223382884692
Nintendo 3DS,81,14,4,99,0.9595959595959596
Shin Megami Tensei: Devil Survivor Overclocked,163,145,13,321,0.9595015576323987
BLACKHOLE (2014),58,13,3,74,0.9594594594594594
Danganronpa 1-2 Reload,124,18,6,148,0.9594594594594594
Final Fantasy XIV: Stormblood,1379,109,63,1551,0.9593810444874274
The Legend of Heroes: Trails in the Sky SC,172,16,8,196,0.9591836734693877
God of War: Ragnarok - Valhalla,217,18,10,245,0.9591836734693877
Metal Gear Survive,172,1377,66,1615,0.9591331269349845
The Legend of Zelda: Ocarina of Time,7672,515,349,8536,0.9591143392689785
Super Mario Galaxy 2,2275,131,103,2509,0.958947787963332
Out of the Park Baseball 16,57,13,3,73,0.958904109589041
Infinity Wars - Animated Trading Card Game,57,13,3,73,0.958904109589041
The Legend of Zelda: Ocarina of Time / Master Quest,152,11,7,170,0.9588235294117647
Zero Escape: Virtue's Last Reward,529,52,25,606,0.9587458745874587
Resident Evil 2,8379,519,385,9283,0.9585263384681676
The Evil Within: The Consequence,425,36,20,481,0.9584199584199584
Blues and Bullets,39,30,3,72,0.9583333333333334
Dungeon Travelers 2: The Royal Library & the Monster Seal,40,6,2,48,0.9583333333333334
Nioh 2: The First Samurai,37,9,2,48,0.9583333333333334
Drakan: Order of the Flame,42,4,2,48,0.9583333333333334
Theatrhythm Final Bar Line,90,24,5,119,0.957983193277311
Bug Fables: The Everlasting Sapling,192,36,10,238,0.957983193277311
Tiger Woods PGA Tour 2005,28,40,3,71,0.9577464788732394
Castlevania Advance Collection,52,16,3,71,0.9577464788732394
Astral Chain,3096,247,148,3491,0.9576052706960756
Yaris,21,24,2,47,0.9574468085106383
Citadels (2013),4,86,4,94,0.9574468085106383
Strategic Mind: Blitzkrieg,26,19,2,47,0.9574468085106383
Pikmin 3,737,50,35,822,0.9574209245742092
Sairento VR,50,17,3,70,0.9571428571428572
Star Trek: D-A-C,41,26,3,70,0.9571428571428572
Hollow Knight: Voidheart Edition,496,35,24,555,0.9567567567567568
Persona 5 Royal,4505,667,235,5407,0.9565378213427039
Everybody's Golf VR,55,11,3,69,0.9565217391304348
The Letter (2014),8,36,2,46,0.9565217391304348
Tales From The Borderlands: Episode 5 - The Vault of the Traveler,535,100,29,664,0.9563253012048193
Ori and the Will of the Wisps,3560,286,176,4022,0.9562406762804575
Final Fantasy VI,647,93,34,774,0.9560723514211886
Xenoblade Chronicles,1720,106,84,1910,0.956020942408377
CTR: Crash Team Racing,562,46,28,636,0.9559748427672956
Resident Evil 2 (1998),1485,47,71,1603,0.9557080474111042
Kirby and the Forgotten Land,710,45,35,790,0.9556962025316456
Dwarf Fortress,210,27,11,248,0.9556451612903226
Mario Kart 8,1812,148,91,2051,0.9556313993174061
Eternity: The Last Unicorn,21,22,2,45,0.9555555555555556
FIFA 21,291,3719,187,4197,0.9554443650226352
Zero Escape: The Nonary Games,310,32,16,358,0.9553072625698324
Metal Gear Solid HD Collection,689,59,35,783,0.9553001277139208
Crash Bandicoot: Warped,779,33,38,850,0.9552941176470588
Gran Turismo 4,799,34,39,872,0.9552752293577982
Out of the Park Baseball 17,68,164,11,243,0.9547325102880658
Galactic Civilizations II: Dark Avatar,35,7,2,44,0.9545454545454546
MLB The Show 16,143,46,9,198,0.9545454545454546
YOGA MASTER,33,9,2,44,0.9545454545454546
Etrian Odyssey 2 Untold: The Fafnir Knight,53,10,3,66,0.9545454545454546
Sam & Max Save the World Remastered,36,27,3,66,0.9545454545454546
Super Mario Advance 4: Super Mario Bros. 3,341,15,17,373,0.9544235924932976
Dark Souls: Artorias of the Abyss,281,33,15,329,0.9544072948328267
Okami,552,34,28,614,0.9543973941368078
drowning (Rapture),151,16,8,175,0.9542857142857143
Dark Souls III,10132,816,528,11476,0.953990937608923
Fire Emblem: Three Houses,2612,228,137,2977,0.9539805172992946
Fast & Furious Crossroads,46,306,17,369,0.9539295392953929
Monster Rancher 1 & 2 DX,226,22,12,260,0.9538461538461539
Disgaea 4 Complete+,39,23,3,65,0.9538461538461539
Splatoon 2: Octo Expansion,222,25,12,259,0.9536679536679536
Extinction,12,132,7,151,0.9536423841059603
Kingdom Hearts HD 2.5 ReMIX,430,42,23,495,0.9535353535353536
Xenoblade Chronicles: Definitive Edition,1234,99,65,1398,0.9535050071530758
Hollow Knight,4636,285,241,5162,0.9533126695079427
Diablo II: Resurrected,925,2109,149,3183,0.9531888155827836
Hearthstone: Heroes of Warcraft - Kobolds & Catacombs,13,48,3,64,0.953125
Statik,51,10,3,64,0.953125
The Sims 3: Katy Perry's Sweet Treats,27,34,3,64,0.953125
EarthNight,48,13,3,64,0.953125
The Orange Box,2207,171,117,2495,0.9531062124248497
Company of Heroes 2,1085,4500,276,5861,0.9529090598873913
Call of Duty: Modern Warfare,4684,9902,721,15307,0.9528973672176129
Space Rangers HD: A War Apart,180,22,10,212,0.9528301886792453
Banjo-Kazooie,638,28,33,699,0.9527896995708155
Warcraft III: The Frozen Throne,1706,49,87,1842,0.9527687296416938
Silent Hill 2: Director's Cut,340,62,20,422,0.95260663507109
Chained Echoes,391,51,22,464,0.9525862068965517
Xenoblade Chronicles X,1613,113,86,1812,0.9525386313465783
Final Fantasy IX,2254,171,121,2546,0.9524744697564808
Utawarerumono: Mask of Truth,111,9,6,126,0.9523809523809523
Fire Pro Wrestling World,33,7,2,42,0.9523809523809523
Firewall Zero Hour,240,40,14,294,0.9523809523809523
Final Fantasy Chronicles,160,20,9,189,0.9523809523809523
GOODGAME EMPIRE,9,31,2,42,0.9523809523809523
Batman: Arkham Collection,35,5,2,42,0.9523809523809523
Chibi-Robo,38,2,2,42,0.9523809523809523
Friday The 13th: The Game - Ultimate Slasher Switch Edition,31,9,2,42,0.9523809523809523
Nioh 2: Darkness in the Capital,33,7,2,42,0.9523809523809523
Pokemon SoulSilver Version,965,51,51,1067,0.9522024367385192
Gothic II: Gold Edition,207,12,11,230,0.9521739130434783
Dark Souls,3708,311,202,4221,0.9521440416962805
Call of Duty: Modern Warfare III,319,1806,107,2232,0.9520609318996416
Shin Megami Tensei: Persona 4,653,181,42,876,0.952054794520548
The Legend of Zelda: A Link Between Worlds,1589,77,84,1750,0.952
Persona 4 Arena,299,295,30,624,0.9519230769230769
Tinykin,163,15,9,187,0.9518716577540107
Dying Light: Platinum Edition,68,11,4,83,0.9518072289156626
Uncharted 4: A Thief's End,15173,1273,836,17282,0.9516259692165259
The Legend of Heroes: Trails to Azure,51,8,3,62,0.9516129032258065
Don Bradman Cricket 17,42,17,3,62,0.9516129032258065
Pathologic 2,334,38,19,391,0.9514066496163683
Fire Emblem: Awakening,1500,81,81,1662,0.9512635379061372
BoxBoy! + BoxGirl!,32,7,2,41,0.9512195121951219
Burnhouse Lane,37,2,2,41,0.9512195121951219
Immortals Fenyx Rising: The Lost Gods,10,29,2,41,0.9512195121951219
Bayonetta 2,1770,154,99,2023,0.9510627780523975
Motorcycle Club,7,51,3,61,0.9508196721311475
Dust n Wheels,54,4,3,61,0.9508196721311475
Shin Megami Tensei IV: Apocalypse,188,139,17,344,0.9505813953488372
Resident Evil: Origins Collection,167,25,10,202,0.9504950495049505
Pokemon HeartGold Version,985,48,54,1087,0.9503219871205152
Half-Life 2: Episode Two,1875,49,101,2025,0.9501234567901234
NieR: Automata - Become as Gods Edition,810,47,45,902,0.950110864745011
Mega Man Maverick Hunter X,139,13,8,160,0.95
Quern - Undying Thoughts,36,2,2,40,0.95
Escape From Paradise City,21,17,2,40,0.95
7th Dragon III Code: VFD,48,9,3,60,0.95
Mortal Online,14,24,2,40,0.95
Tokyo Dark: Remembrance,34,4,2,40,0.95
Nintendo Labo: Toycon 04 VR Kit,38,19,3,60,0.95
Tony Hawk's Pro Skater 5,64,520,31,615,0.9495934959349593
Star Ocean: The Second Story R,87,7,5,99,0.9494949494949495
Kingdom Hearts HD I.5 + II.5 Remix,641,72,38,751,0.9494007989347537
Mana Khemia: Alchemists of Al-Revis,58,17,4,79,0.9493670886075949
Super Mario World: Super Mario Advance 2,291,8,16,315,0.9492063492063492
Overwatch 2,471,4105,245,4821,0.9491806679112217
Black Paradox,37,19,3,59,0.9491525423728814
Silent Hill 2: Restless Dreams,49,7,3,59,0.9491525423728814
Persona 4 Arena Ultimax,248,293,29,570,0.9491228070175438
Resident Evil Village Gold Edition,26,67,5,98,0.9489795918367347
Command & Conquer Remastered Collection,255,24,15,294,0.9489795918367347
Dog's Life,20,110,7,137,0.948905109489051
The Neverhood,156,11,9,176,0.9488636363636364
Fate/Samurai Remnant,68,6,4,78,0.9487179487179487
Fallout Trilogy,33,4,2,39,0.9487179487179487
Hatsune Miku: Project Diva Future Tone - Future Sound,60,14,4,78,0.9487179487179487
Commandos: Beyond the Call of Duty,70,4,4,78,0.9487179487179487
Mr. Saitou,31,6,2,39,0.9487179487179487
Yu-Gi-Oh! 5D's Wheelie Breakers,73,1,4,78,0.9487179487179487
3 Stars of Destiny,34,3,2,39,0.9487179487179487
Ever17: The Out of Infinity,34,3,2,39,0.9487179487179487
Skullgirls: 2nd Encore,73,75,8,156,0.9487179487179487
Baten Kaitos I & II HD Remaster,31,6,2,39,0.9487179487179487
Mindjack,13,153,9,175,0.9485714285714286
AO International Tennis,85,44,7,136,0.9485294117647058
The Legend of Heroes: Trails from Zero,78,14,5,97,0.9484536082474226
Portal 2,11113,437,628,12178,0.9484315979635408
The Legend of Zelda: Ocarina of Time 3D,1804,88,103,1995,0.9483709273182958
Final Fantasy XV Pocket Edition,301,66,20,387,0.9483204134366925
Star Wars: Knights of the Old Republic,2416,109,138,2663,0.9481787457754413
The Legend of Zelda: Twilight Princess HD,502,46,30,578,0.9480968858131488
Mega Man Zero Collection,64,9,4,77,0.948051948051948
Mega Man Zero / ZX Legacy Collection,157,98,14,269,0.9479553903345725
Ashes Cricket,70,21,5,96,0.9479166666666666
Metroid Prime 2: Echoes,393,24,23,440,0.9477272727272728
OutRun,60,12,4,76,0.9473684210526315
GhostControl Inc.,29,7,2,38,0.9473684210526315
The Walking Dead: The Telltale Definitive Series,187,29,12,228,0.9473684210526315
Guilty Gear XX Accent Core Plus,45,9,3,57,0.9473684210526315
Grand Theft Auto IV: The Complete Edition,120,24,8,152,0.9473684210526315
The King of Fighters 2002 Unlimited Match,32,4,2,38,0.9473684210526315
Inazuma Eleven Go: Chrono Stones - Thunderflash,33,3,2,38,0.9473684210526315
Formula One Championship Edition,30,6,2,38,0.9473684210526315
My Time at Sandrock,24,12,2,38,0.9473684210526315
Legends of Aethereus,19,17,2,38,0.9473684210526315
Little Noah: Scion of Paradise,23,13,2,38,0.9473684210526315
Infinite Space,28,8,2,38,0.9473684210526315
Lumines Remastered,42,12,3,57,0.9473684210526315
Wo Long: Fallen Dynasty,1714,364,116,2194,0.9471285323609845
Sekiro: Shadows Die Twice,8972,1051,560,10583,0.9470849475574034
Rain World,239,29,15,283,0.9469964664310954
WWE 2K20,48,488,30,566,0.9469964664310954
Forza Horizon 3: Hot Wheels,99,26,7,132,0.946969696969697
Dragon Quest VIII: Journey of the Cursed King,437,45,27,509,0.9469548133595285
The Last of Us Part II,85765,68664,8653,163082,0.9469408027863283
Vagrant Story,202,12,12,226,0.9469026548672567
DOOM: Unto The Evil,74,15,5,94,0.9468085106382979
BioShock Infinite: Complete Edition,162,16,10,188,0.9468085106382979
DmC: Devil May Cry - Bloody Palace,54,17,4,75,0.9466666666666667
Race with Ryan,19,52,4,75,0.9466666666666667
Mega Man Powered Up,114,10,7,131,0.9465648854961832
God of War: Origins Collection,335,19,20,374,0.946524064171123
13 Sentinels: Aegis Rim,508,40,31,579,0.9464594127806563
Kinectimals: Now with Bears!,8,45,3,56,0.9464285714285714
Desperados: Wanted Dead or Alive,132,9,8,149,0.9463087248322147
Octopath Traveler II,482,64,31,577,0.9462738301559792
World of Final Fantasy Maxima,74,14,5,93,0.946236559139785
Shin Megami Tensei IV,440,158,34,632,0.9462025316455697
Uncharted 2: Among Thieves,5857,354,354,6565,0.9460776846915461
Uncharted 2: Among Thieves - Siege Expansion Pack,22,13,2,37,0.9459459459459459
Metroid: Zero Mission,377,8,22,407,0.9459459459459459
Afro Samurai 2: Revenge of Kuma Volume One,17,53,4,74,0.9459459459459459
Moss: Book II,55,15,4,74,0.9459459459459459
The Elder Scrolls Online: Tamriel Unlimited - Orsinium,18,17,2,37,0.9459459459459459
Mario & Luigi: Bowser's Inside Story + Bowser Jr.'s Journey,86,19,6,111,0.9459459459459459
FIFA 20,420,4781,298,5499,0.9458083287870522
Rayman Legends: Definitive Edition,257,22,16,295,0.9457627118644067
FreeSpace 2,113,9,7,129,0.9457364341085271
Dreams,1215,144,78,1437,0.9457202505219207
Master of Orion II: Battle at Antares,48,4,3,55,0.9454545454545454
Final Fantasy IV: The Complete Collection,189,19,12,220,0.9454545454545454
N++,71,33,6,110,0.9454545454545454
Attack on Titan 2: Final Battle,136,20,9,165,0.9454545454545454
Deus Ex,1255,61,76,1392,0.9454022988505747
NieR: Automata,5746,464,359,6569,0.9453493682447861
Final Fantasy X / X-2 HD Remaster,1758,282,118,2158,0.9453197405004634
Tekken 3,858,23,51,932,0.9452789699570815
Hyperdimension Neptunia Re;Birth3: V Generation,55,14,4,73,0.9452054794520548
Baldur's Gate: Siege of Dragonspear,197,355,32,584,0.9452054794520548
Age of Empires II: Definitive Edition,457,43,29,529,0.945179584120983
Silent Hill,838,41,51,930,0.9451612903225807
God of War II,1784,60,107,1951,0.9451563300871348
X3: Albion Prelude,93,10,6,109,0.944954128440367
Pikmin 2,294,14,18,326,0.9447852760736196
Red Dead Redemption: Game of the Year Edition,142,12,9,163,0.9447852760736196
SpongeBob SquarePants: Battle for Bikini Bottom - Rehydrated,2710,298,176,3184,0.9447236180904522
Claire,26,8,2,36,0.9444444444444444
Star Ruler 2,40,11,3,54,0.9444444444444444
Hyperdrive Massacre,27,7,2,36,0.9444444444444444
Arma 3 Apex,28,6,2,36,0.9444444444444444
Myth II: Soulblighter,62,6,4,72,0.9444444444444444
Underhero,30,4,2,36,0.9444444444444444
Killer Instinct Season 2,88,31,7,126,0.9444444444444444
Ib,31,3,2,36,0.9444444444444444
The Elder Scrolls IV: Oblivion - Game of the Year Edition,204,17,13,234,0.9444444444444444
Lethal League Blaze,28,6,2,36,0.9444444444444444
Apex Construct,21,13,2,36,0.9444444444444444
Resident Evil 3: Nemesis,1341,50,82,1473,0.9443312966734555
DOOM II,792,73,51,916,0.9443231441048034
Atelier Ryza 2: Lost Legends & the Secret Fairy,320,52,22,394,0.9441624365482234
Toukiden 2,121,31,9,161,0.9440993788819876
Cuphead in the Delicious Last Course,265,22,17,304,0.944078947368421
Astro's Playroom,1486,64,92,1642,0.9439707673568819
Destiny 2: Curse of Osiris,69,748,49,866,0.9434180138568129
Wuppo,43,7,3,53,0.9433962264150944
Grand Theft Auto: The Trilogy,52,48,6,106,0.9433962264150944
Stellaris: Utopia,44,6,3,53,0.9433962264150944
SpongeBob HeroPants,8,42,3,53,0.9433962264150944
JSRF: Jet Set Radio Future,96,4,6,106,0.9433962264150944
Outcast,46,4,3,53,0.9433962264150944
LISA,170,13,11,194,0.9432989690721649
Project Wingman: Frontline 59,67,16,5,88,0.9431818181818182
RollerCoaster Tycoon 3: Soaked!,35,48,5,88,0.9431818181818182
Dungeon Keeper 2,161,5,10,176,0.9431818181818182
DOOM Eternal,10578,964,698,12240,0.9429738562091503
The Sims 2: Nightlife,15,18,2,35,0.9428571428571428
Villagers and Heroes,29,4,2,35,0.9428571428571428
RimWorld Console Edition,28,5,2,35,0.9428571428571428
The Kindeman Remedy,65,1,4,70,0.9428571428571428
Library Of Ruina,27,6,2,35,0.9428571428571428
TrackMania United,55,11,4,70,0.9428571428571428
Darkfall Unholy Wars,71,28,6,105,0.9428571428571428
Acting Lessons,28,5,2,35,0.9428571428571428
LostWinds,23,142,10,175,0.9428571428571428
Fallout 76,3159,9681,782,13622,0.9425928644839231
Deracine,65,17,5,87,0.9425287356321839
Vampire: The Masquerade - Bloodlines,843,42,54,939,0.9424920127795527
Ys VIII: Lacrimosa of DANA,707,78,48,833,0.9423769507803121
Master Levels for DOOM II,46,3,3,52,0.9423076923076923
Outlast: Bundle of Terror,43,6,3,52,0.9423076923076923
Red Dead Redemption,6043,248,386,6677,0.9421896061105287
Bayonetta Origins: Cereza and the Lost Demon,103,11,7,121,0.9421487603305785
Obscure: The Aftermath,76,54,8,138,0.9420289855072463
Prime World,47,18,4,69,0.9420289855072463
Genital Jousting,55,10,4,69,0.9420289855072463
God of War Collection,807,70,54,931,0.9419978517722879
KORG M01D,77,4,5,86,0.9418604651162791
Donkey Kong Country: Tropical Freeze,1519,100,100,1719,0.941826643397324
Crash Team Rumble,98,80,11,189,0.9417989417989417
Disgaea 4: A Promise Unforgotten,168,26,12,206,0.941747572815534
Suikoden V,102,11,7,120,0.9416666666666667
Gran Turismo 2,355,16,23,394,0.9416243654822335
Diablo IV,2401,14552,1051,18004,0.9416240835369918
Metroid Prime Remastered,1029,115,71,1215,0.9415637860082304
Blade of Darkness (2001),133,12,9,154,0.9415584415584416
OneShot,241,16,16,273,0.9413919413919414
R.B.I. Baseball 15,10,22,2,34,0.9411764705882353
Eternal Card Game,22,10,2,34,0.9411764705882353
Rise of the Guardians,9,23,2,34,0.9411764705882353
inFamous Collection,29,3,2,34,0.9411764705882353
Blade Runner: Enhanced Edition,10,22,2,34,0.9411764705882353
"Nine Hours, Nine Persons, Nine Doors",286,17,19,322,0.9409937888198758
Star Wars Battlefront II,1886,10926,805,13617,0.9408827201292502
Signalis,325,41,23,389,0.9408740359897172
God of War III,2843,100,185,3128,0.9408567774936062
Warcraft III: Reign of Chaos,2251,51,145,2447,0.9407437678790356
Madden NFL 20,71,706,49,826,0.940677966101695
MLB 11: The Show,77,18,6,101,0.9405940594059405
Arcania: Fall of Setarrif,7,72,5,84,0.9404761904761905
Super Mario Bros. Wonder,1481,47,97,1625,0.9403076923076923
The Legend of Zelda: Breath of the Wild,20791,2338,1469,24598,0.9402796975363851
Half-Life 2,8209,361,545,9115,0.9402084476138234
Deltarune: Chapter 2,205,15,14,234,0.9401709401709402
The Last of Us Part I,2212,1253,221,3686,0.9400434074877917
Claw,45,2,3,50,0.94
The Last of Us: Left Behind,2131,1713,246,4090,0.9398533007334964
Age of Wonders III - Eternal Lords,112,13,8,133,0.9398496240601504
Battle Princess Madelyn,49,29,5,83,0.9397590361445783
Style Savvy: Trendsetters,76,2,5,83,0.9397590361445783
Cadence of Hyrule: Crypt of the NecroDancer Featuring The Legend of Zelda,247,49,19,315,0.9396825396825397
World of Warcraft: Dragonflight,242,598,54,894,0.9395973154362416
Final Fantasy Tactics,763,60,53,876,0.9394977168949772
Steins;Gate 0,226,22,16,264,0.9393939393939394
Death Jr. II: Root of Evil,30,1,2,33,0.9393939393939394
Fable Heroes,13,18,2,33,0.9393939393939394
Kick-Ass 2,3,28,2,33,0.9393939393939394
Hegemony Gold: Wars of Ancient Greece,26,5,2,33,0.9393939393939394
Red Game Without A Great Name,23,8,2,33,0.9393939393939394
Orc Slayer,6,25,2,33,0.9393939393939394
Ritual: Crown of Horns,23,8,2,33,0.9393939393939394
Winds of Change,29,2,2,33,0.9393939393939394
Phoenix Wright: Ace Attorney Trilogy,436,44,31,511,0.9393346379647749
Destiny 2: The Witch Queen,301,70,24,395,0.9392405063291139
Ring Fit Adventure,257,21,18,296,0.9391891891891891
Kirby Super Star Ultra,133,6,9,148,0.9391891891891891
Castlevania: Aria of Sorrow,206,10,14,230,0.9391304347826087
Monster Hunter 4 Ultimate,383,33,27,443,0.9390519187358917
Mega Man Anniversary Collection,57,20,5,82,0.9390243902439024
The Last Remnant Remastered,57,20,5,82,0.9390243902439024
Final Fantasy X,1622,84,111,1817,0.9389102916895983
The Curse of Monkey Island,337,16,23,376,0.9388297872340425
Mega Man Battle Network 3: White Version,35,11,3,49,0.9387755102040817
Worlds of Magic: Planar Conquest,27,19,3,49,0.9387755102040817
Gladius (2003),43,3,3,49,0.9387755102040817
Microsoft Flight Simulator,1455,472,126,2053,0.9386264003896736
Knights of Honor,101,6,7,114,0.9385964912280702
Theatrhythm Final Fantasy: Curtain Call,181,33,14,228,0.9385964912280702
Mega Man X Legacy Collection 1 + 2,159,55,14,228,0.9385964912280702
Pokemon Sword / Shield Dual Pack,152,230,25,407,0.9385749385749386
3000th Duel,54,7,4,65,0.9384615384615385
Utawarerumono: Mask of Deception,123,14,9,146,0.9383561643835616
Rise of Nations: Extended Edition,62,14,5,81,0.9382716049382716
The Wonderful 101,476,40,34,550,0.9381818181818182
Radiant Historia,183,14,13,210,0.9380952380952381
Implosion - Never Lose Hope,89,17,7,113,0.9380530973451328
Freedom Planet,211,31,16,258,0.937984496124031
Moss,209,33,16,258,0.937984496124031
Grand Theft Auto: San Andreas,7370,314,509,8193,0.9378737947027951
Super Smash Bros. Ultimate,3526,307,254,4087,0.9378517249816491
Starcraft,1060,36,73,1169,0.9375534644995723
Gigantic,64,11,5,80,0.9375
Pathologic Classic HD,98,7,7,112,0.9375
Gears of War 2: Game of the Year Edition,28,2,2,32,0.9375
Guardian Heroes,26,4,2,32,0.9375
Europa Universalis IV: Res Publica,23,7,2,32,0.9375
Guild Wars 2: Path of Fire,191,64,17,272,0.9375
Conker's Bad Fur Day,323,22,23,368,0.9375
NES Remix Pack,27,3,2,32,0.9375
Go Vacation,76,14,6,96,0.9375
The Walking Dead: The Telltale Series - The Final Season Episode 3: Broken Toys,85,20,7,112,0.9375
Farm Together,25,5,2,32,0.9375
Disciples: Liberation,54,66,8,128,0.9375
Divinity: Original Sin II,2305,182,166,2653,0.9374293252921221
The Walking Dead: A Telltale Games Series - Game of the Year Edition,494,60,37,591,0.937394247038917
Megadimension Neptunia VII,141,38,12,191,0.93717277486911
The Legend of Zelda: Majora's Mask 3D,781,53,56,890,0.9370786516853933
Fire Emblem: Path of Radiance,231,6,16,253,0.9367588932806324
Masquerade: The Baubles of Doom,56,18,5,79,0.9367088607594937
R4: Ridge Racer Type 4,69,5,5,79,0.9367088607594937
Railroad Tycoon II,69,5,5,79,0.9367088607594937
Gnomoria,54,5,4,63,0.9365079365079365
Rakuen,115,17,9,141,0.9361702127659575
XBLAZE Code: Embryo,35,9,3,47,0.9361702127659575
SaGa Scarlet Grace: Ambitions,32,12,3,47,0.9361702127659575
Mutant Football League: Dynasty Edition,35,9,3,47,0.9361702127659575
The Legend of Heroes: Trails of Cold Steel II,356,54,28,438,0.9360730593607306
BioShock: The Collection,1302,133,98,1533,0.9360730593607306
Mafia,1955,78,139,2172,0.9360036832412523
Supreme Commander: Forged Alliance,201,18,15,234,0.9358974358974359
Super Mario 3D World,2003,112,145,2260,0.9358407079646017
Mario Kart 8 Deluxe,2622,177,192,2991,0.9358074222668004
Cricket 19,83,19,7,109,0.9357798165137615
BONEWORKS,116,15,9,140,0.9357142857142857
Black Desert Online,1023,546,108,1677,0.9355992844364938
Tokyo Xtreme Racer DRIFT 2,25,4,2,31,0.9354838709677419
Fantasy Strike,68,19,6,93,0.9354838709677419
Little Adventure on the Prairie,5,24,2,31,0.9354838709677419
The King of Fighters Collection: The Orochi Saga,23,6,2,31,0.9354838709677419
Duck Dynasty,20,96,8,124,0.9354838709677419
Nightfall: Escape,84,3,6,93,0.9354838709677419
Harvest Moon: One World,19,39,4,62,0.9354838709677419
Counter-Strike 1: Anthology,23,6,2,31,0.9354838709677419
BioShock Ultimate Rapture Edition,52,6,4,62,0.9354838709677419
Jumanji: The Video Game,8,50,4,62,0.9354838709677419
PixelJunk Monsters Deluxe,25,4,2,31,0.9354838709677419
SaGa Frontier Remastered,21,8,2,31,0.9354838709677419
Borderlands Legendary Collection,75,12,6,93,0.9354838709677419
Reknum,22,7,2,31,0.9354838709677419
Everlasting Summer,594,43,44,681,0.9353891336270191
The Walking Dead: Episode 5 - No Time Left,711,111,57,879,0.9351535836177475
Shin Megami Tensei V,562,159,50,771,0.9351491569390402
Aaru's Awakening,44,302,24,370,0.9351351351351351
Marvel's Spider-Man,8849,454,646,9949,0.9350688511408182
Batman: Arkham City - Game of the Year Edition,69,3,5,77,0.935064935064935
Guilty Gear -Strive-,204,55,18,277,0.9350180505415162
The Legend of Zelda: A Link to the Past / Four Swords,631,30,46,707,0.9349363507779349
Elden Ring,18200,5086,1621,24907,0.9349178945677922
Shin Megami Tensei: Persona 3 FES,647,157,56,860,0.9348837209302325
Dragon Ball Z for Kinect,5,38,3,46,0.9347826086956522
Shroud of the Avatar: Forsaken Virtues,27,16,3,46,0.9347826086956522
Heroes of Might and Magic II: The Price of Loyalty,41,2,3,46,0.9347826086956522
Tin Hearts,38,5,3,46,0.9347826086956522
Call of Duty: Ghosts - Devastation,20,23,3,46,0.9347826086956522
Pop Island: Paperfield,81,5,6,92,0.9347826086956522
Metal Arms: Glitch in the System,38,5,3,46,0.9347826086956522
Digimon Story Cyber Sleuth: Complete Edition,125,47,12,184,0.9347826086956522
Crusader Kings II: The Republic,51,6,4,61,0.9344262295081968
Duelyst,47,10,4,61,0.9344262295081968
AI: The Somnium Files - nirvanA Initiative,201,27,16,244,0.9344262295081968
Guilty Gear Xrd -REVELATOR-,147,24,12,183,0.9344262295081968
The Fall Part 2: Unbound,46,11,4,61,0.9344262295081968
RimWorld,576,35,43,654,0.9342507645259939
Blockland,45,26,5,76,0.9342105263157895
Ninja Gaiden: Master Collection,177,64,17,258,0.9341085271317829
The Legend of Zelda: The Wind Waker,1351,52,99,1502,0.9340878828229028
Warcraft II: Tides of Darkness,83,2,6,91,0.9340659340659341
The Wolf Among Us: Episode 1 - Faith,1127,91,86,1304,0.9340490797546013
God of War: Ragnarok,8641,1843,741,11225,0.9339866369710468
Warcraft II: Battle.net Edition,96,3,7,106,0.9339622641509434
Chrono Cross,394,30,30,454,0.933920704845815
Soul Sacrifice Delta,127,14,10,151,0.9337748344370861
Sonic Mania,1784,198,141,2123,0.9335845501648611
Dawn of Fantasy: Kingdom Wars,67,17,6,90,0.9333333333333333
Ancient Domains of Mystery,21,7,2,30,0.9333333333333333
Lobotomy Corporation: Monster Management Simulation,24,4,2,30,0.9333333333333333
Twinsen's Odyssey,52,4,4,60,0.9333333333333333
The Mensional,27,1,2,30,0.9333333333333333
Asgard's Wrath 2,63,7,5,75,0.9333333333333333
Air Conflicts: Vietnam Ultimate Edition,4,24,2,30,0.9333333333333333
Wings! Remastered Edition,23,5,2,30,0.9333333333333333
NASCAR Heat 3,17,11,2,30,0.9333333333333333
Re:ZERO - Starting Life in Another World: The Prophecy of the Throne,23,5,2,30,0.9333333333333333
Urban Flow,21,7,2,30,0.9333333333333333
ParaWorld,23,5,2,30,0.9333333333333333
DreamWorks How to Train Your Dragon 2,16,12,2,30,0.9333333333333333
Boomerang Fu,40,2,3,45,0.9333333333333333
Outlast Trinity,25,3,2,30,0.9333333333333333
Shogun: Total War Warlord Edition,38,4,3,45,0.9333333333333333
Pinball FX,1,41,3,45,0.9333333333333333
Paranormasight: The Seven Mysteries of Honjo,62,8,5,75,0.9333333333333333
Astria Ascending,18,24,3,45,0.9333333333333333
Wrestling Empire,49,7,4,60,0.9333333333333333
Disco Elysium,1249,149,100,1498,0.9332443257676902
P.T.,320,29,25,374,0.9331550802139037
Steelrising,694,113,58,865,0.9329479768786128
Killer Instinct Season 3,95,44,10,149,0.9328859060402684
Sword of the Stars II: Lords of Winter,56,69,9,134,0.9328358208955224
Star Wars Rogue Leader: Rogue Squadron II,121,4,9,134,0.9328358208955224
Dota 2,7307,3900,807,12014,0.9328283669052772
Fire Emblem,230,6,17,253,0.932806324110672
Minecraft: Story Mode - Episode 4: A Block and a Hard Place,55,28,6,89,0.9325842696629213
The Cat Lady,220,15,17,252,0.9325396825396826
Midnight Club 3: DUB Edition Remix,145,7,11,163,0.9325153374233128
Yuppie Psycho,63,6,5,74,0.9324324324324325
Overlord: Fellowship of Evil,15,54,5,74,0.9324324324324325
Heart of Darkness,66,3,5,74,0.9324324324324325
NBA 2K20,189,1657,134,1980,0.9323232323232323
Mass Effect Legendary Edition,1408,518,140,2066,0.9322362052274927
Death Stranding,14923,4731,1429,21083,0.9322202722572689
Twisted Metal 2,50,5,4,59,0.9322033898305084
Mass Effect 2,8087,389,617,9093,0.9321456065105026
Mass Effect Trilogy,178,28,15,221,0.9321266968325792
Ultimate General: Gettysburg,128,23,11,162,0.9320987654320988
Return of the Obra Dinn,534,42,42,618,0.9320388349514563
Bayonetta + Bayonetta 2,392,33,31,456,0.9320175438596491
IL-2 Sturmovik: Forgotten Battles,35,6,3,44,0.9318181818181818
Cold Iron,34,7,3,44,0.9318181818181818
RollerCoaster Tycoon 2: Wacky Worlds,21,20,3,44,0.9318181818181818
Hexen: Beyond Heretic,38,3,3,44,0.9318181818181818
Guild Wars Nightfall,73,9,6,88,0.9318181818181818
Major\Minor,34,7,3,44,0.9318181818181818
Prototype Biohazard Bundle,100,64,12,176,0.9318181818181818
Theme Hospital,117,6,9,132,0.9318181818181818
Blade Runner,63,5,5,73,0.9315068493150684
Rumble Roses XX,54,41,7,102,0.9313725490196079
Day of Infamy,46,8,4,58,0.9310344827586207
Ultima Online,45,9,4,58,0.9310344827586207
Dariusburst: Chronicle Saviours,43,11,4,58,0.9310344827586207
Astalon: Tears of the Earth,35,19,4,58,0.9310344827586207
Kenshi,242,28,20,290,0.9310344827586207
Sonic Free Riders,26,122,11,159,0.9308176100628931
Tormented Souls,211,58,20,289,0.9307958477508651
Forza Horizon 3,1391,288,125,1804,0.9307095343680709
Etrian Odyssey Untold: The Millennium Girl,84,10,7,101,0.9306930693069307
Super Mario 3D World + Bowser's Fury,905,48,71,1024,0.9306640625
Ratchet & Clank: Rift Apart,2595,328,218,3141,0.9305953517987902
Guncraft,30,37,5,72,0.9305555555555556
Original War,62,5,5,72,0.9305555555555556
Superman Returns,7,194,15,216,0.9305555555555556
Royal Quest,4,36,3,43,0.9302325581395349
Sudden Attack,7,33,3,43,0.9302325581395349
StopGate,71,9,6,86,0.9302325581395349
Mobile Suit Gundam: Extreme VS. MaxiBoost ON,30,10,3,43,0.9302325581395349
Fobia - St. Dinfna Hotel,94,26,9,129,0.9302325581395349
Dying Light 2 Stay Human,3888,4271,612,8771,0.9302246038080036
Metroid Prime 3: Corruption,403,23,32,458,0.9301310043668122
Crusader Kings II: The Old Gods,158,15,13,186,0.9301075268817204
Dragon Quest V: Hand of the Heavenly Bride,124,9,10,143,0.9300699300699301
Therian Saga,84,9,7,100,0.93
Gothic,1088,81,88,1257,0.9299920445505171
Odin Sphere Leifthrasir,375,50,32,457,0.9299781181619255
Hades,3404,205,272,3881,0.9299149703684617
Guilty Gear Xrd: Rev 2,103,16,9,128,0.9296875
Chocobo GP,21,111,10,142,0.9295774647887324
Starpoint Gemini,56,10,5,71,0.9295774647887324
Wallace & Gromit in Project Zoo,13,66,6,85,0.9294117647058824
The Ultimate DOOM,165,6,13,184,0.9293478260869565
Undertale,5868,911,516,7295,0.9292666209732694
NEKOPARA Vol. 2,26,92,9,127,0.9291338582677166
NIER,614,54,51,719,0.9290681502086231
Ninja Gaiden Black,160,10,13,183,0.9289617486338798
The Walking Dead: Episode 2 - Starved for Help,640,91,56,787,0.928843710292249
Kirby: Planet Robobot,210,11,17,238,0.9285714285714286
Gnosia,48,4,4,56,0.9285714285714286
Fatal Frame III: The Tormented,87,4,7,98,0.9285714285714286
Command & Conquer: Red Alert 2 - Yuri's Revenge,236,11,19,266,0.9285714285714286
Forza Horizon 5: Hot Wheels,182,52,18,252,0.9285714285714286
The Legend of Heroes: Trails in the Sky,362,41,31,434,0.9285714285714286
Star Trek Online: Legacy of Romulus,36,3,3,42,0.9285714285714286
The Expendables 2 Videogame,27,64,7,98,0.9285714285714286
Demon Gaze,98,6,8,112,0.9285714285714286
Road Trip (2002),31,8,3,42,0.9285714285714286
Rekoil,11,41,4,56,0.9285714285714286
Inazuma Eleven 2: Firestorm,37,2,3,42,0.9285714285714286
Marvel's Spider-Man 2,6164,412,506,7082,0.9285512567071449
Medieval II: Total War,756,10,59,825,0.9284848484848485
The World Ends with You,283,41,25,349,0.9283667621776505
EVE Online,194,90,22,306,0.9281045751633987
The Legend of Dragoon,306,29,26,361,0.9279778393351801
Wipeout: Omega Collection,260,49,24,333,0.9279279279279279
The Walking Dead: Destinies,17,73,7,97,0.9278350515463918
Final DOOM,84,6,7,97,0.9278350515463918
Horizon Forbidden West,8969,2090,861,11920,0.9277684563758389
The Binding of Isaac: Afterbirth,280,41,25,346,0.9277456647398844
Forza Motorsport 4,649,70,56,775,0.927741935483871
Outer Wilds,1246,153,109,1508,0.9277188328912467
The Walking Dead: A Telltale Games Series,5038,314,417,5769,0.9277171086843474
Persona Q2: New Cinema Labyrinth,60,17,6,83,0.927710843373494
Titanfall 2,4511,327,377,5215,0.9277085330776605
Commandos: Behind Enemy Lines,135,6,11,152,0.9276315789473685
Banjo-Tooie,261,21,22,304,0.9276315789473685
Sid Meier's Civilization V: Brave New World,611,42,51,704,0.9275568181818182
Tales From The Borderlands: Episode 1 - Zer0 Sum,556,97,51,704,0.9275568181818182
Steel Division: Normandy 44,53,11,5,69,0.927536231884058
KUNAI,109,19,10,138,0.927536231884058
Stardew Valley,2570,181,215,2966,0.9275118004045853
XCOM: Enemy Within,235,46,22,303,0.9273927392739274
Forza Horizon,669,45,56,770,0.9272727272727272
Ashes of the Singularity: Escalation,42,9,4,55,0.9272727272727272
Crusader Kings II: Sons of Abraham,41,10,4,55,0.9272727272727272
Kingdom Come: Deliverance - Royal Edition,48,3,4,55,0.9272727272727272
Quantum Error,14,37,4,55,0.9272727272727272
Forza Horizon 4,2404,373,218,2995,0.927212020033389
Forza Motorsport 6,745,183,73,1001,0.9270729270729271
World of Warcraft: Battle for Azeroth,378,1970,185,2533,0.9269640742202921
Disciples II: Gold Edition,36,2,3,41,0.926829268292683
Sports Story,2,36,3,41,0.926829268292683
Ground Control II: Operation Exodus,34,4,3,41,0.926829268292683
Snoopy vs. the Red Baron,35,3,3,41,0.926829268292683
War Tech Fighters,29,9,3,41,0.926829268292683
Ghost Giant,28,10,3,41,0.926829268292683
Tearaway,418,25,35,478,0.9267782426778243
Corpse Party,179,36,17,232,0.9267241379310345
Nexomon: Extinction,120,19,11,150,0.9266666666666666
Talisman: Digital Edition,64,37,8,109,0.926605504587156
Vietcong (2003),95,6,8,109,0.926605504587156
Bendy and the Dark Revival,81,20,8,109,0.926605504587156
Splatoon,1248,90,106,1444,0.9265927977839336
P.N. 03,60,3,5,68,0.9264705882352942
Dragon Age: Inquisition - Game of the Year Edition,52,11,5,68,0.9264705882352942
Thief: The Dark Project,384,19,32,435,0.9264367816091954
Arcanum: Of Steamworks and Magick Obscura,315,25,27,367,0.9264305177111717
Xenoblade Chronicles 2,2124,243,188,2555,0.9264187866927593
Guild Wars 2: Heart of Thorns,677,240,73,990,0.9262626262626262
The Settlers: New Allies,19,81,8,108,0.9259259259259259
Romancing SaGa 3 (Remaster),54,21,6,81,0.9259259259259259
Splasher,42,8,4,54,0.9259259259259259
Dark Souls III: The Fire Fades Edition,88,12,8,108,0.9259259259259259
Sakuna: Of Rice and Ruin,124,26,12,162,0.9259259259259259
The Legend of Zelda: Twilight Princess,2313,124,195,2632,0.9259118541033434
Dragon Quest XI: Echoes of an Elusive Age,1126,110,99,1335,0.9258426966292135
WWE SmackDown! Here Comes the Pain,133,4,11,148,0.9256756756756757
LEGO Batman: The Videogame,1179,450,131,1760,0.9255681818181818
Sly 2: Band of Thieves,356,17,30,403,0.9255583126550868
Steel Battalion: Heavy Armor,16,71,7,94,0.925531914893617
Final Fantasy XIV Online: A Realm Reborn,2910,692,290,3892,0.9254881808838643
Phoenix Wright: Ace Attorney - Spirit of Justice,127,22,12,161,0.9254658385093167
The Legend of Zelda: Breath of the Wild - The Champion's Ballad,335,37,30,402,0.9253731343283582
Phantasy Star Online: Blue Burst,49,13,5,67,0.9253731343283582
Dengeki Bunko: Fighting Climax,56,6,5,67,0.9253731343283582
Death Stranding: Director's Cut,866,247,90,1203,0.9251870324189526
Advance Wars,131,5,11,147,0.9251700680272109
Half-Life,4403,149,369,4921,0.9250152408047145
Star Ocean: Second Evolution,33,4,3,40,0.925
Primordia,175,10,15,200,0.925
OlliOlli World: VOID Riders,31,6,3,40,0.925
Ori and the Blind Forest,2495,202,219,2916,0.9248971193415638
The Legend of Zelda: Tears of the Kingdom,9273,1486,874,11633,0.9248689074185507
Yakuza Kiwami 2,563,52,50,665,0.924812030075188
GhostWire: Tokyo,2623,351,242,3216,0.9247512437810945
Xenoblade Chronicles 2: Torna ~ The Golden Country,393,37,35,465,0.9247311827956989
Demon's Souls (2009),1463,96,127,1686,0.924673784104389
Days Gone,10637,993,948,12578,0.9246303068850373
MLB The Show 17,108,39,12,159,0.9245283018867925
Aeterna Noctis,75,23,8,106,0.9245283018867925
Cuphead,3159,323,285,3767,0.9243429784974782
Minecraft: Story Mode Season Two - Episode 2: Giant Consequences,42,19,5,66,0.9242424242424242
Dance Central 2,56,5,5,66,0.9242424242424242
Samurai Warriors 4-II,47,14,5,66,0.9242424242424242
Suzerain,54,7,5,66,0.9242424242424242
Startopia,55,6,5,66,0.9242424242424242
Blood (1997),129,5,11,145,0.9241379310344827
Forza Horizon 5,4337,1006,439,5782,0.9240747146316154
WWF No Mercy,62,11,6,79,0.9240506329113924
Detroit: Become Human,6638,470,586,7694,0.923836755913699
Homeworld 2,102,7,9,118,0.923728813559322
NieR Replicant ver.1.22474487139...,850,103,79,1032,0.9234496124031008
Killzone: Mercenary,560,31,49,640,0.9234375
Life is Strange: Before the Storm - Episode 2: Brave New World,165,40,17,222,0.9234234234234234
Forza Horizon 2,1112,202,109,1423,0.9234012649332396
Marvel's Guardians of the Galaxy,2924,192,259,3375,0.9232592592592592
Diablo II,1543,69,134,1746,0.9232531500572738
Ultimate Ghosts 'n Goblins,42,6,4,52,0.9230769230769231
Grim Dawn: Ashes of Malmouth,33,3,3,39,0.9230769230769231
Pac-Man Championship Edition 2 Plus,28,8,3,39,0.9230769230769231
Buried Stars,29,7,3,39,0.9230769230769231
MechWarrior 4: Mercenaries,34,2,3,39,0.9230769230769231
Einhander,33,3,3,39,0.9230769230769231
Mario Tennis: Power Tour,34,2,3,39,0.9230769230769231
Fate/Extra,41,7,4,52,0.9230769230769231
Sonic the Hedgehog 3,91,5,8,104,0.9230769230769231
Shinsekai: Into the Depths,31,5,3,39,0.9230769230769231
Mighty Morphin Power Rangers: Mega Battle,74,22,8,104,0.9230769230769231
Distant Worlds: Universe,81,15,8,104,0.9230769230769231
Ori and the Blind Forest: Definitive Edition,1396,125,127,1648,0.9229368932038835
Baldur's Gate,800,38,70,908,0.9229074889867841
The Legend of Zelda: The Minish Cap,443,10,38,491,0.9226069246435845
Return to Castle Wolfenstein: Enemy Territory,210,16,19,245,0.9224489795918367
Eternal Darkness: Sanity's Requiem,206,8,18,232,0.9224137931034483
Silent Storm,85,10,8,103,0.9223300970873787
Digimon World: Next Order,125,53,15,193,0.9222797927461139
Persona 4: Dancing All Night,183,149,28,360,0.9222222222222223
Romance of the Three Kingdoms XIV,70,13,7,90,0.9222222222222223
Fantasia: Music Evolved,54,17,6,77,0.922077922077922
Yakuza: Like a Dragon,1091,163,106,1360,0.9220588235294118
Life is Strange: Episode 4 - Dark Room,612,73,58,743,0.9219380888290714
Castlevania Anniversary Collection,91,27,10,128,0.921875
Shakedown Hawaii,71,47,10,128,0.921875
Professor Layton and the Unwound Future,168,9,15,192,0.921875
Elite: Dangerous - Odyssey,19,40,5,64,0.921875
Metal Gear Solid HD Edition,249,22,23,294,0.9217687074829932
Atomic Heart,2955,1073,342,4370,0.9217391304347826
Freelancer,203,9,18,230,0.9217391304347826
WarioWare Gold,84,10,8,102,0.9215686274509803
Final Fantasy Anthology,44,3,4,51,0.9215686274509803
Secret World Legends,24,23,4,51,0.9215686274509803
Layers of Fear: Legacy,36,11,4,51,0.9215686274509803
Tales of Symphonia,251,19,23,293,0.9215017064846417
Burnout Revenge,290,3,25,318,0.9213836477987422
DCS World,73,9,7,89,0.9213483146067416
Fallout,1275,71,115,1461,0.921286789869952
Genshin Impact,1918,3184,436,5538,0.9212712170458649
Mega Man X Legacy Collection,76,41,10,127,0.9212598425196851
Little Town Hero,82,105,16,203,0.9211822660098522
Cave Story,227,30,22,279,0.921146953405018
Death Jr.,34,1,3,38,0.9210526315789473
Pure Farming 2018,24,11,3,38,0.9210526315789473
Roboquest,32,3,3,38,0.9210526315789473
Nelke & the Legendary Alchemists: Ateliers of the New World,50,20,6,76,0.9210526315789473
Shadow Blade: Reload,28,7,3,38,0.9210526315789473
Spirit Hunter: NG,30,5,3,38,0.9210526315789473
Europa Universalis IV,1284,104,119,1507,0.9210351692103517
Portal,4190,97,368,4655,0.9209452201933405
Mass Effect 2: Lair of the Shadow Broker,391,28,36,455,0.9208791208791208
Shantae and the Pirate's Curse,377,42,36,455,0.9208791208791208
The Sims 4: Get Together,93,35,11,139,0.920863309352518
ENDER LILIES: Quietus of the Knights,264,38,26,328,0.9207317073170732
Dark Age of Camelot,45,13,5,63,0.9206349206349206
Dragon Quest Builders 2,344,50,34,428,0.9205607476635514
The Operative: No One Lives Forever,209,11,19,239,0.9205020920502092
Mario & Luigi: Superstar Saga,218,13,20,251,0.9203187250996016
Golden Sun,238,16,22,276,0.9202898550724637
Halo: Combat Evolved,2875,240,270,3385,0.9202363367799113
Ys: Memories of Celceta,299,35,29,363,0.9201101928374655
Stronghold: Crusader,340,17,31,388,0.9201030927835051
Final Fantasy XV: Episode Prompto,367,36,35,438,0.9200913242009132
Final Fantasy XV: Episode Gladiolus,363,40,35,438,0.9200913242009132
Baten Kaitos: Eternal Wings and the Lost Ocean,62,7,6,75,0.92
Downhill Domination,42,4,4,50,0.92
Monster Energy Supercross - The Official Videogame 2,25,21,4,50,0.92
One Step From Eden,53,16,6,75,0.92
Distant Worlds,41,5,4,50,0.92
Operation Flashpoint: Resistance,43,3,4,50,0.92
Forza Horizon 2: Storm Island,75,17,8,100,0.92
Oceanhorn 2: Knights of the Lost Realm,61,8,6,75,0.92
Hitman: Blood Money,926,25,83,1034,0.9197292069632496
Madden NFL 19,59,342,35,436,0.9197247706422018
MLB The Show 21,195,183,33,411,0.9197080291970803
Shenmue I & II,368,67,38,473,0.919661733615222
Max Payne,2107,54,189,2350,0.9195744680851063
Grounded,260,83,30,373,0.9195710455764075
Final Fantasy VI Pixel Remaster,66,14,7,87,0.9195402298850575
Evil Dead: A Fistful of Boomstick,50,30,7,87,0.9195402298850575
The Henry Stickmin Collection,128,9,12,149,0.9194630872483222
NBA 2K18,190,1122,115,1427,0.9194113524877365
Ogre Battle 64: Person of Lordly Caliber,47,10,5,62,0.9193548387096774
Fell Seal: Arbiter's Mark,85,29,10,124,0.9193548387096774
Supraland,101,13,10,124,0.9193548387096774
Battle Realms,54,3,5,62,0.9193548387096774
Disco Elysium: The Final Cut,1579,230,159,1968,0.9192073170731707
Yakuza 5,247,26,24,297,0.9191919191919192
Tennis World Tour 2,138,78,19,235,0.9191489361702128
Emperor: Rise of the Middle Kingdom,28,6,3,37,0.918918918918919
Omega Labyrinth Life,24,10,3,37,0.918918918918919
Wipeout Pulse,32,2,3,37,0.918918918918919
KARDS,26,8,3,37,0.918918918918919
Motocross Madness (2013),55,13,6,74,0.918918918918919
Attacking Zegeta,17,17,3,37,0.918918918918919
Pentiment,433,133,50,616,0.9188311688311688
NieR: Automata - Game of the YoRHa Edition,849,56,80,985,0.9187817258883249
Aliens Versus Predator 2,176,5,16,197,0.9187817258883249
Super Smash Bros. for Nintendo 3DS / Wii U,2662,177,251,3090,0.9187702265372168
Forza Horizon 3: Blizzard Mountain,91,22,10,123,0.9186991869918699
Forza Motorsport (2005),71,8,7,86,0.9186046511627907
Homeworld: Cataclysm,75,4,7,86,0.9186046511627907
DOOM (1993),478,52,47,577,0.9185441941074524
SSX Tricky,116,8,11,135,0.9185185185185185
Uncharted: The Nathan Drake Collection,3134,179,294,3607,0.9184918214582756
Final Fantasy XVI,7738,1557,825,10120,0.9184782608695652
Monster Hunter: World - Iceborne,537,82,55,674,0.9183976261127597
Guilty Gear Xrd -SIGN-,221,49,24,294,0.9183673469387755
Midnight Club 3: DUB Edition,125,10,12,147,0.9183673469387755
Mega Man & Bass,39,6,4,49,0.9183673469387755
Streets of Rogue,42,3,4,49,0.9183673469387755
The Last Blade 2,34,11,4,49,0.9183673469387755
Cyberpunk 2077,30103,17991,4279,52373,0.9182975960895882
Senran Kagura: Estival Versus,190,46,21,257,0.9182879377431906
Tony Hawk's Pro Skater 1 + 2,871,129,89,1089,0.9182736455463728
Legacy of Kain: Soul Reaver,321,16,30,367,0.9182561307901907
Resident Evil 4 HD,2321,205,225,2751,0.9182115594329335
Alan Wake II,1986,203,195,2384,0.9182046979865772
Tomb Raider II,93,8,9,110,0.9181818181818182
Clive Barker's Undying,149,8,14,171,0.9181286549707602
Final Fantasy Explorers,186,27,19,232,0.9181034482758621
R.I.P.D. The Game,13,99,10,122,0.9180327868852459
Worms Armageddon,162,6,15,183,0.9180327868852459
Super Mega Baseball 2,42,14,5,61,0.9180327868852459
Wolfenstein: Cyberpilot,16,40,5,61,0.9180327868852459
XCOM 2 Collection,39,17,5,61,0.9180327868852459
Cave Story 3D,58,9,6,73,0.9178082191780822
Door Kickers: Action Squad,57,10,6,73,0.9178082191780822
Homeworld,322,24,31,377,0.9177718832891246
Tokyo Mirage Sessions #FE,316,63,34,413,0.9176755447941889
Mortal Kombat Komplete Edition,971,43,91,1105,0.9176470588235294
Advance Wars 2: Black Hole Rising,68,10,7,85,0.9176470588235294
Darkarta: A Broken Heart's Quest,72,6,7,85,0.9176470588235294
There is no game : Wrong dimension,155,12,15,182,0.9175824175824175
Mafia III: Sign of the Times,74,15,8,97,0.9175257731958762
Katana ZERO,942,48,89,1079,0.917516218721038
Grim Fandango,665,34,63,762,0.9173228346456693
Animal Crossing: New Leaf,818,45,78,941,0.9171094580233794
Mass Effect 3: Citadel,619,100,65,784,0.9170918367346939
Need for Speed: Most Wanted (2005),1693,132,165,1990,0.9170854271356784
Black Mesa,1101,48,104,1253,0.9169992019154031
Atelier Ryza: Ever Darkness & the Secret Hideout,261,37,27,325,0.916923076923077
Mega Man Battle Network 6: Cybeast Gregar,25,8,3,36,0.9166666666666666
Brave Fencer Musashi,30,3,3,36,0.9166666666666666
Racing Gears Advance,30,3,3,36,0.9166666666666666
Robo Recall,27,6,3,36,0.9166666666666666
The Blackwell Epiphany,65,12,7,84,0.9166666666666666
Parkitect,31,2,3,36,0.9166666666666666
Just Dance 2023 Edition,17,16,3,36,0.9166666666666666
Sword of the Necromancer,26,7,3,36,0.9166666666666666
Moto Racer 4,11,22,3,36,0.9166666666666666
Metropolis Street Racer,30,3,3,36,0.9166666666666666
Hellblade: Senua's Sacrifice VR Edition,28,5,3,36,0.9166666666666666
Melbits World,23,10,3,36,0.9166666666666666
NHL 10,38,6,4,48,0.9166666666666666
Huntdown,181,39,20,240,0.9166666666666666
Brigandine: The Legend of Runersia,67,10,7,84,0.9166666666666666
The Legend of Heroes: Trails of Cold Steel,558,57,56,671,0.9165424739195231
Shadow Tactics: Blades of the Shogun,504,44,50,598,0.9163879598662207
Halo: The Master Chief Collection,1763,349,193,2305,0.9162689804772234
Resident Evil HD Remaster,2002,172,199,2373,0.9161399072903498
Life is Strange: Episode 3 - Chaos Theory,519,59,53,631,0.9160063391442155
Magic: The Gathering Arena,48,159,19,226,0.915929203539823
The King of Fighters XIV,253,41,27,321,0.9158878504672897
Hell Let Loose,212,71,26,309,0.9158576051779935
Halo Infinite,5317,1423,620,7360,0.9157608695652174
Batman: Arkham City - Armored Edition,222,17,22,261,0.9157088122605364
Romancing SaGa 2,64,12,7,83,0.9156626506024096
Paradigm Paradox,73,3,7,83,0.9156626506024096
Rising Storm,208,20,21,249,0.9156626506024096
Monkey Island 2 Special Edition: LeChuck's Revenge,317,30,32,379,0.9155672823218998
Devil May Cry 5,3677,541,389,4607,0.9155632732797916
Sphinx and the Cursed Mummy,51,14,6,71,0.9154929577464789
Super Mario 64,1999,80,192,2271,0.9154557463672391
X Rebirth,275,924,111,1310,0.9152671755725191
Project Gotham Racing 2,48,6,5,59,0.9152542372881356
Polybius,43,11,5,59,0.9152542372881356
The Walking Dead: Episode 4 - Around Every Corner,349,50,37,436,0.9151376146788991
Warriors Orochi 3 Ultimate,448,37,45,530,0.9150943396226415
Okami HD,970,127,102,1199,0.9149291075896581
ZEN Pinball 2: South Park: Super-Sweet Pinball,30,13,4,47,0.9148936170212766
Mario + Rabbids: Kingdom Battle - Donkey Kong Adventure,78,8,8,94,0.9148936170212766
Panzer Corps,69,17,8,94,0.9148936170212766
Final Fantasy Tactics A2: Grimoire of the Rift,194,10,19,223,0.9147982062780269
Raven's Cry,28,90,11,129,0.9147286821705426
SSX 3,171,22,18,211,0.9146919431279621
CrossCode,248,52,28,328,0.9146341463414634
Resogun: Defenders,57,18,7,82,0.9146341463414634
Parasite Eve,176,6,17,199,0.914572864321608
GoldenEye 007,757,44,75,876,0.9143835616438356
Saints Row,409,1447,174,2030,0.9142857142857143
Icarus,15,17,3,35,0.9142857142857143
Halo 2,1806,146,183,2135,0.9142857142857143
Seduce Me,8,24,3,35,0.9142857142857143
Stranger of Sword City,53,11,6,70,0.9142857142857143
CORPSE FACTORY,29,3,3,35,0.9142857142857143
Assault Android Cactus+,29,3,3,35,0.9142857142857143
Dragon Star Varnir,23,9,3,35,0.9142857142857143
Mega Man Star Force 3: Black Ace,25,7,3,35,0.9142857142857143
Kirby's Return to Dream Land,246,10,24,280,0.9142857142857143
Entropia Universe,12,20,3,35,0.9142857142857143
Shiren the Wanderer: The Tower of Fortune and the Dice of Fate,28,4,3,35,0.9142857142857143
Shrek: Super Party,16,16,3,35,0.9142857142857143
Hannah Montana: The Movie,22,42,6,70,0.9142857142857143
Tiny Bunny,28,4,3,35,0.9142857142857143
Yakuza 6: The Song of Life,497,57,52,606,0.9141914191419142
Digimon World 3,132,17,14,163,0.9141104294478528
DOOM,7042,585,717,8344,0.9140699904122723
Final Fantasy XV: Episode Ardyn,105,12,11,128,0.9140625
Shadow Hearts,78,7,8,93,0.9139784946236559
Forspoken,566,1357,181,2104,0.9139733840304183
The Walking Dead: Season Two Episode 1 - All That Remains,686,89,73,848,0.9139150943396226
Spacebase DF-9,12,41,5,58,0.9137931034482759
Pharaoh,51,2,5,58,0.9137931034482759
God Wars: Future Past,39,14,5,58,0.9137931034482759
Final Fantasy Pixel Remaster: FF35th Anniversary Edition,47,6,5,58,0.9137931034482759
Shin Megami Tensei: Devil Summoner - Soul Hackers,118,136,24,278,0.9136690647482014
Lost Judgment,322,59,36,417,0.9136690647482014
Judgment,659,71,69,799,0.9136420525657072
Phantom Dust,52,22,7,81,0.9135802469135802
Disciples II: Dark Prophecy,142,6,14,162,0.9135802469135802
Fire Emblem Echoes: Shadows of Valentia,364,27,37,428,0.9135514018691588
Mortal Kombat 11,1155,2277,325,3757,0.9134948096885813
Spyro Reignited Trilogy,1117,158,121,1396,0.913323782234957
Star Trek: Bridge Crew,64,20,8,92,0.9130434782608695
SuperMash,14,28,4,46,0.9130434782608695
Wanted: Dead,129,81,20,230,0.9130434782608695
FlatOut 3: Chaos & Destruction,111,246,34,391,0.9130434782608695
Age of Conan: Rise of the Godslayer,33,9,4,46,0.9130434782608695
Everhood,72,12,8,92,0.9130434782608695
Divinity: Original Sin,1942,168,201,2311,0.9130246646473388
The Elder Scrolls III: Morrowind,1587,90,160,1837,0.9129014697876974
Monster Hunter Rise,946,846,171,1963,0.912888436067244
Final Fantasy XIV Online,115,262,36,413,0.9128329297820823
Severed,154,24,17,195,0.9128205128205128
Silent Hill 3,741,65,77,883,0.912797281993205
Deus Ex: Human Revolution - Director's Cut,872,70,90,1032,0.9127906976744186
A Hat in Time,662,60,69,791,0.9127686472819216
Ghostrunner 2,84,10,9,103,0.912621359223301
Anthem,1737,3628,514,5879,0.9125701649940466
World Pool Championship 2007,71,2,7,80,0.9125
BioShock Infinite: Burial at Sea - Episode Two,859,69,89,1017,0.9124877089478859
Rune Factory 3: A Fantasy Harvest Moon,47,5,5,57,0.9122807017543859
The Alliance Alive HD Remastered,35,17,5,57,0.9122807017543859
"Prinny 2: Dawn of Operation Panties, Dood!",49,3,5,57,0.9122807017543859
Battlefield 1: In the Name of the Tsar,30,22,5,57,0.9122807017543859
Songs for a Hero,44,8,5,57,0.9122807017543859
Gas Guzzlers Extreme,139,17,15,171,0.9122807017543859
Aliens Versus Predator,48,4,5,57,0.9122807017543859
System Shock: Enhanced Edition,77,6,8,91,0.9120879120879121
Tactics Ogre: Let Us Cling Together,130,15,14,159,0.9119496855345912
Animal Crossing: New Horizons,3452,2689,594,6735,0.911804008908686
Charlie and the Chocolate Factory,26,5,3,34,0.9117647058823529
Tales of Maj'Eyal,46,16,6,68,0.9117647058823529
Drake of the 99 Dragons,3,28,3,34,0.9117647058823529
Until Dawn: Rush of Blood,162,24,18,204,0.9117647058823529
CastleMiner Z,11,20,3,34,0.9117647058823529
Lost Judgment: The Kaito Files,23,8,3,34,0.9117647058823529
Rainbow Billy: The Curse of the Leviathan,19,12,3,34,0.9117647058823529
Doki Doki Literature Club Plus!,306,35,33,374,0.9117647058823529
Disney's Toontown Online,21,10,3,34,0.9117647058823529
Samurai Warriors 4 Empires,24,7,3,34,0.9117647058823529
Oddworld: Abe's Exoddus,143,12,15,170,0.9117647058823529
Beat Saber,336,36,36,408,0.9117647058823529
Forspoken: In Tanta We Trust,42,20,6,68,0.9117647058823529
Werewolves Within,22,9,3,34,0.9117647058823529
Tenkai Knights: Brave Battle,7,24,3,34,0.9117647058823529
Jet Car Stunts,18,13,3,34,0.9117647058823529
ISS Pro Evolution,52,10,6,68,0.9117647058823529
Dogchild,18,13,3,34,0.9117647058823529
Silver (1999),28,3,3,34,0.9117647058823529
Creeper World,29,2,3,34,0.9117647058823529
Yu-Gi-Oh! Master Duel,238,20,25,283,0.911660777385159
Rayman Legends,2857,254,302,3413,0.9115147963668327
Battleship (2012),19,84,10,113,0.911504424778761
Hatsune Miku: Project Diva Future Tone - Colorful Tone,61,11,7,79,0.9113924050632911
Puppeteer,240,27,26,293,0.9112627986348123
Tales of Xillia,432,40,46,518,0.9111969111969112
Asgard's Wrath,70,12,8,90,0.9111111111111111
Tales of Phantasia,29,12,4,45,0.9111111111111111
F1 Challenge '99-'02,70,12,8,90,0.9111111111111111
AR-K Episode 3: The Great Escape,32,9,4,45,0.9111111111111111
Command & Conquer: Red Alert 2,445,16,45,506,0.9110671936758893
Dark Souls: Prepare to Die Edition,1910,425,228,2563,0.9110417479516192
Grandia II,138,15,15,168,0.9107142857142857
Rise to Honor,46,5,5,56,0.9107142857142857
Kingdom Hearts,1008,63,105,1176,0.9107142857142857
Command: Modern Air / Naval Operations,17,34,5,56,0.9107142857142857
Final Fantasy VII Remake,6468,1104,743,8315,0.9106434155141311
F-Zero X,118,4,12,134,0.9104477611940298
Super Smash Bros. Brawl,1299,41,132,1472,0.9103260869565217
RUNE II: Decapitation Edition,27,44,7,78,0.9102564102564102
Fallout: New Vegas,7238,348,748,8334,0.9102471802255819
The Secret World,1028,158,117,1303,0.9102072141212586
The Binding of Isaac: Afterbirth +,331,44,37,412,0.9101941747572816
Rocksmith 2014 Edition,254,60,31,345,0.9101449275362319
Warriors Orochi 4 Ultimate,70,11,8,89,0.9101123595505618
FAST Racing NEO,150,12,16,178,0.9101123595505618
Cassette Beasts,73,8,8,89,0.9101123595505618
Stephen's Sausage Roll,49,42,9,100,0.91
Metroid: Samus Returns,560,36,59,655,0.9099236641221374
The Walking Dead: Saints & Sinners,178,24,20,222,0.9099099099099099
Cities XXL,20,192,21,233,0.9098712446351931
NHL 23,24,87,11,122,0.9098360655737705
LEGO DC Super-Villains,311,153,46,510,0.9098039215686274
Code Name: S.T.E.A.M.,109,22,13,144,0.9097222222222222
Resident Evil: Revelations 2 - Episode 3: Judgment,109,32,14,155,0.9096774193548387
The Beatles: Rock Band,126,25,15,166,0.9096385542168675
Monster Hunter Freedom Unite,139,22,16,177,0.9096045197740112
Sonic Mania Plus,617,57,67,741,0.9095816464237517
Life is Strange,5077,394,544,6015,0.9095594347464672
The Elder Scrolls Online: Tamriel Unlimited,1594,354,194,2142,0.9094304388422035
Returnal,2953,983,392,4328,0.9094269870609981
Black Book,235,16,25,276,0.9094202898550725
Tom Clancy's Ghost Recon: Breakpoint,531,1607,213,2351,0.9094002552105487
Hearts of Iron II: Doomsday,28,2,3,33,0.9090909090909091
Super House of Dead Ninjas,36,4,4,44,0.9090909090909091
Worms Revolution Extreme,22,8,3,33,0.9090909090909091
Metal Fatigue,46,4,5,55,0.9090909090909091
The Wolf Among Us: Episode 5 - Cry Wolf,492,58,55,605,0.9090909090909091
Lord of Magna: Maiden Heaven,32,8,4,44,0.9090909090909091
Phantasy Star Online,34,6,4,44,0.9090909090909091
New Little King's Story,33,7,4,44,0.9090909090909091
Virtua Fighter 4: Evolution,35,5,4,44,0.9090909090909091
The Elder Scrolls Anthology,45,5,5,55,0.9090909090909091
Chibi-Robo! Photo Finder,24,6,3,33,0.9090909090909091
Guild Wars 2 : Secrets of the Obscure,28,12,4,44,0.9090909090909091
Streets of Rage 4: Mr. X Nightmare,42,8,5,55,0.9090909090909091
Tenchu: Wrath of Heaven,48,2,5,55,0.9090909090909091
Capitalism II,35,5,4,44,0.9090909090909091
Silence of the Sleep,24,6,3,33,0.9090909090909091
The Cycle,19,21,4,44,0.9090909090909091
Tiny Metal: Full Metal Rumble,23,7,3,33,0.9090909090909091
The King of Fighters XIII,128,22,15,165,0.9090909090909091
Stormland,24,6,3,33,0.9090909090909091
Black Desert,51,69,12,132,0.9090909090909091
Dungeon Encounters,21,9,3,33,0.9090909090909091
Dishonored 2,3813,451,427,4691,0.9089746322745683
Kingdom Hearts HD 1.5 ReMIX,453,36,49,538,0.9089219330855018
Life is Strange: Episode 2 - Out of Time,494,54,55,603,0.9087893864013267
World of Warcraft: The Burning Crusade,841,484,133,1458,0.9087791495198903
Pokemon Platinum Version,936,39,98,1073,0.9086672879776329
Mega Man 11,365,112,48,525,0.9085714285714286
Parasite Eve II,138,11,15,164,0.9085365853658537
Borderlands 2: Tiny Tina's Assault on Dragon Keep,269,29,30,328,0.9085365853658537
Gran Turismo,399,28,43,470,0.9085106382978724
MLB 13: The Show,111,18,13,142,0.9084507042253521
Pokemon Emerald Version,790,42,84,916,0.9082969432314411
Marvel's Spider-Man Remastered,1036,83,113,1232,0.9082792207792207
Age of Wonders III - Golden Realms,91,8,10,109,0.908256880733945
Systematic Insanity,87,2,9,98,0.9081632653061225
Atelier Rorona Plus: The Alchemist of Arland,75,14,9,98,0.9081632653061225
Cossacks: Back to War,83,6,9,98,0.9081632653061225
Yakuza 2,84,5,9,98,0.9081632653061225
The Talos Principle,649,53,71,773,0.908150064683053
Donkey Kong Country Returns,711,50,77,838,0.9081145584725537
Dragon Ball Z: Budokai Tenkaichi 3,466,18,49,533,0.9080675422138836
Kingdom Hearts: Birth by Sleep,462,51,52,565,0.9079646017699115
SpongeBob SquarePants: Plankton's Robotic Revenge,31,38,7,76,0.9078947368421053
Dark Souls Remastered,2875,395,332,3602,0.9078289838978345
Stella Glow,106,12,12,130,0.9076923076923077
The Settlers II,47,2,5,54,0.9074074074074074
Strike Vector,39,10,5,54,0.9074074074074074
Heavy Rain & Beyond: Two Souls Collection,272,22,30,324,0.9074074074074074
Sacred 3,60,508,58,626,0.9073482428115016
Metal Gear Solid Integral,219,16,24,259,0.9073359073359073
Final Fantasy IV (3D Remake),355,46,41,442,0.9072398190045249
Starcraft Remastered,201,43,25,269,0.9070631970260223
Swords & Soldiers II,31,8,4,43,0.9069767441860465
Cobalt,26,13,4,43,0.9069767441860465
BlazBlue: Continuum Shift,68,10,8,86,0.9069767441860465
Giana Sisters: Twisted Dreams - Rise of the Owlverlord,34,5,4,43,0.9069767441860465
Savant - Ascent,33,6,4,43,0.9069767441860465
Danganronpa 2: Goodbye Despair,498,27,54,579,0.9067357512953368
Being a DIK - Season 1,65,3,7,75,0.9066666666666666
Dreamfall Chapters Book Two: Rebels,54,14,7,75,0.9066666666666666
Against the Storm,61,7,7,75,0.9066666666666666
Zero Escape: Zero Time Dilemma,378,59,45,482,0.9066390041493776
Final Fantasy VIII,1207,84,133,1424,0.9066011235955056
Sudden Strike 4,76,21,10,107,0.9065420560747663
Garry's Mod,890,31,95,1016,0.906496062992126
BlazBlue: Central Fiction,128,27,16,171,0.9064327485380117
Kingdom Come: Deliverance,3245,675,405,4325,0.9063583815028902
King's Bounty: The Legend,283,17,31,331,0.9063444108761329
Ni no Kuni: Wrath of the White Witch,1103,97,124,1324,0.9063444108761329
Clone Drone in the Danger Zone,25,4,3,32,0.90625
Earthworm Jim 2,24,5,3,32,0.90625
Mega Man Legacy Collection + Mega Man Legacy Collection 2,19,10,3,32,0.90625
Citadel: Forged with Fire,19,10,3,32,0.90625
Toy Soldiers: Cold War,104,12,12,128,0.90625
Clash of the Titans: The Videogame,6,23,3,32,0.90625
NBA Street Vol. 2,52,6,6,64,0.90625
Crypt of the Serpent King,16,13,3,32,0.90625
SoulCalibur,356,50,42,448,0.90625
Phantasy Star Online 2,56,31,9,96,0.90625
Mafia: Trilogy,24,5,3,32,0.90625
IS Defense,24,5,3,32,0.90625
International Superstar Soccer '98,46,12,6,64,0.90625
LawBreakers,155,96,26,277,0.9061371841155235
Heavy Rain: Move Edition,94,12,11,117,0.905982905982906
Fire Emblem: The Sacred Stones,205,7,22,234,0.905982905982906
Homeworld Remastered Collection,290,47,35,372,0.9059139784946236
Horizon Zero Dawn,10438,1103,1199,12740,0.9058869701726845
Warriors Orochi 4,109,16,13,138,0.9057971014492754
SimCity,607,3535,431,4573,0.9057511480428603
Starcraft II: Legacy of the Void,978,127,115,1220,0.9057377049180327
Sonic's Ultimate Genesis Collection,80,16,10,106,0.9056603773584906
Panzer Dragoon Orta,45,3,5,53,0.9056603773584906
Prinny: Can I Really Be the Hero?,46,2,5,53,0.9056603773584906
No Man's Sky Beyond,208,32,25,265,0.9056603773584906
Dragon Marked For Death,36,12,5,53,0.9056603773584906
God's Trigger,89,26,12,127,0.905511811023622
The Wolf Among Us,1802,66,195,2063,0.9054774600096946
Under Night In-Birth Exe:Late,56,11,7,74,0.9054054054054054
Super Mega Baseball 3,54,13,7,74,0.9054054054054054
The Age of Decadence,180,40,23,243,0.9053497942386831
Neon White,198,22,23,243,0.9053497942386831
Gears 5,3309,689,418,4416,0.9053442028985508
eFootball PES 2020,921,302,128,1351,0.9052553663952627
Zula - Europe,18,87,11,116,0.9051724137931034
Tekken 5,359,13,39,411,0.9051094890510949
Goat Simulator 3,99,25,13,137,0.9051094890510949
Grand Theft Auto V,24127,3876,2936,30939,0.9051035909370051
Tales of Berseria,646,241,93,980,0.9051020408163265
Oddworld: Abe's Oddysee,211,8,23,242,0.9049586776859504
The Binding of Isaac: Rebirth,1369,182,163,1714,0.9049008168028004
Super Mario Maker 2,880,71,100,1051,0.9048525214081827
El Chavo Kart,45,12,6,63,0.9047619047619048
Mega Man Legends 2,44,13,6,63,0.9047619047619048
Rebuild 3: Gangs of Deadsville,51,6,6,63,0.9047619047619048
Dragon Quest III,31,7,4,42,0.9047619047619048
Eiyuu Senki: The World Conquest,32,6,4,42,0.9047619047619048
Rogue Aces,23,15,4,42,0.9047619047619048
South Park: The Stick of Truth,3151,220,355,3726,0.904723564143854
Medal of Honor (1999),248,8,27,283,0.9045936395759717
Final Fantasy Tactics Advance,251,14,28,293,0.9044368600682594
The Secret of Monkey Island: Special Edition,355,33,41,429,0.9044289044289044
Blasphemous 2,210,36,26,272,0.9044117647058824
Catherine: Full Body,308,42,37,387,0.9043927648578811
Max Payne 2: The Fall of Max Payne,1471,33,159,1663,0.9043896572459411
Transformers: Fall of Cybertron,403,51,48,502,0.9043824701195219
Galactic Civilizations II: Twilight of the Arnor,94,10,11,115,0.9043478260869565
Heroes of Might and Magic II: The Succession Wars,82,3,9,94,0.9042553191489362
Red Goddess: Inner World,59,26,9,94,0.9042553191489362
Chicken Police - Paint it RED!,332,36,39,407,0.9041769041769042
Little King's Story,61,5,7,73,0.9041095890410958
Metal Gear Solid: The Twin Snakes,190,8,21,219,0.9041095890410958
Fairy Fencer F: Advent Dark Force,46,20,7,73,0.9041095890410958
Evil Dead: The Game,184,108,31,323,0.9040247678018576
Age of Wonders: Shadow Magic,107,6,12,125,0.904
Omensight,96,17,12,125,0.904
Darkstalkers Resurrection,37,10,5,52,0.9038461538461539
WWE SmackDown! Shut Your Mouth,46,1,5,52,0.9038461538461539
EA SPORTS UFC 5,12,82,10,104,0.9038461538461539
Rare Replay,303,54,38,395,0.9037974683544304
Dino Crisis,158,11,18,187,0.9037433155080213
Batman: Return to Arkham,597,41,68,706,0.9036827195467422
Alien: Isolation,4011,370,467,4848,0.9036716171617162
MEVO & The Grooveriders,72,3,8,83,0.9036144578313253
Age of Mythology,689,14,75,778,0.903598971722365
NBA 2K19,199,532,78,809,0.9035846724351051
Attack on Titan 2,281,47,35,363,0.9035812672176309
Horizon Zero Dawn: The Frozen Wilds,776,114,95,985,0.9035532994923858
Mark of the Ninja: Remastered,94,9,11,114,0.9035087719298246
LittleBigPlanet PS Vita,335,30,39,404,0.9034653465346535
The Walking Dead: Episode 3 - Long Road Ahead,449,65,55,569,0.9033391915641477
Disciples II: Gallean's Return,24,4,3,31,0.9032258064516129
Super Dungeon Bros,3,25,3,31,0.9032258064516129
World of Warcraft: Battle Chest,15,13,3,31,0.9032258064516129
Jurassic World Evolution: Complete Edition,23,5,3,31,0.9032258064516129
Deemo Reborn,23,5,3,31,0.9032258064516129
BioShock & The Elder Scrolls IV: Oblivion Bundle,24,4,3,31,0.9032258064516129
Kohan II: Kings of War,27,1,3,31,0.9032258064516129
Field of Glory II,24,4,3,31,0.9032258064516129
Bionic Dues,46,10,6,62,0.9032258064516129
Cruelty Squad,26,2,3,31,0.9032258064516129
Fight Night Round 2,19,9,3,31,0.9032258064516129
King's Quest,71,13,9,93,0.9032258064516129
Ni no Kuni II: Revenant Kingdom - Prince's Edition,24,4,3,31,0.9032258064516129
Breath of Fire IV,86,7,10,103,0.9029126213592233
Battlefield: Play4Free,24,162,20,206,0.9029126213592233
IL-2 Sturmovik,150,8,17,175,0.9028571428571428
Planescape: Torment - Enhanced Edition,103,27,14,144,0.9027777777777778
Blood Omen: Legacy of Kain,61,4,7,72,0.9027777777777778
Underrail,137,30,18,185,0.9027027027027027
Black Rock Shooter: The Game,30,7,4,41,0.9024390243902439
The Room VR: A Dark Matter,27,10,4,41,0.9024390243902439
Solatorobo: Red the Hunter,34,3,4,41,0.9024390243902439
Gauntlet: Dark Legacy,31,6,4,41,0.9024390243902439
The Bradwell Conspiracy,25,12,4,41,0.9024390243902439
Batman: Arkham Asylum,5331,131,591,6053,0.9023624648934413
Monster Hunter Rise: Sunbreak,138,213,38,389,0.9023136246786633
Natural Doctrine,76,44,13,133,0.9022556390977443
Minecraft: Story Mode Season Two - Episode 5: Above and Beyond,36,10,5,51,0.9019607843137255
Pillars of Eternity: The White March - Part 1,114,24,15,153,0.9019607843137255
Halo: Reach - Defiant Map Pack,37,9,5,51,0.9019607843137255
Deemo: The Last Recital,42,4,5,51,0.9019607843137255
WarioWare: Move It!,43,3,5,51,0.9019607843137255
Hex: Shards of Fate,63,38,11,112,0.9017857142857143
Ys: The Oath in Felghana,129,27,17,173,0.9017341040462428
The Lord of the Rings Online: Helm's Deep,13,42,6,61,0.9016393442622951
Killer Queen Black,46,9,6,61,0.9016393442622951
Dragon Quest VII: Fragments of the Forgotten Past,143,22,18,183,0.9016393442622951
Command & Conquer: Generals - Zero Hour,219,10,25,254,0.9015748031496063
Sonic Boom: Rise of Lyric,179,471,71,721,0.9015256588072122
NBA Live 14,49,189,26,264,0.9015151515151515
Dragon Ball Z: Budokai 3,175,8,20,203,0.9014778325123153
Donkey Kong Country 2: Diddy's Kong Quest,60,4,7,71,0.9014084507042254
Atelier Lydie & Suelle: The Alchemists and the Mysterious Paintings,47,17,7,71,0.9014084507042254
"Warhammer 40,000: Rogue Trader",49,15,7,71,0.9014084507042254
WWF SmackDown! 2: Know Your Role,58,6,7,71,0.9014084507042254
Jak 3,376,17,43,436,0.9013761467889908
Godzilla,69,196,29,294,0.9013605442176871
Nioh,2132,279,264,2675,0.9013084112149533
Aqua Moto Racing Utopia,53,20,8,81,0.9012345679012346
Shovel Knight: Treasure Trove,464,56,57,577,0.901213171577123
F1 2016,198,39,26,263,0.9011406844106464
Baldur's Gate: Dark Alliance II,73,9,9,91,0.9010989010989011
Corpse Party: Book of Shadows,69,13,9,91,0.9010989010989011
Stranger of Paradise: Final Fantasy Origin,610,163,85,858,0.9009324009324009
SimCity: Cities of Tomorrow Expansion Pack,31,69,11,111,0.9009009009009009
River City Girls,148,52,22,222,0.9009009009009009
Grand Theft Auto: Vice City,4262,145,485,4892,0.9008585445625511
Monster Hunter 3 Ultimate,467,68,59,594,0.9006734006734006
Thea: The Awakening,144,19,18,181,0.9005524861878453
Subnautica,1703,126,202,2031,0.9005416051206302
The Walking Dead: Season Two Episode 2 - A House Divided,458,66,58,582,0.9003436426116839
Crash Bandicoot N. Sane Trilogy,1813,235,227,2275,0.9002197802197802
Command & Conquer,407,8,46,461,0.9002169197396963
Digimon Story Cyber Sleuth,446,59,56,561,0.9001782531194296
The Elder Scrolls V: Skyrim,16592,2203,2086,20881,0.9001005698960778
Naughty Bear: Panic in Paradise,38,7,5,50,0.9
Art of Balance,85,14,11,110,0.9
Jagged Alliance Online,21,15,4,40,0.9
Destiny: The Collection,30,15,5,50,0.9
Young Souls,27,18,5,50,0.9
Borderlands 2: Commander Lilith & the Fight for Sanctuary,19,8,3,30,0.9
Slay the Princess,41,4,5,50,0.9
Zeus: Master of Olympus,77,4,9,90,0.9
Metroid Fusion,379,8,43,430,0.9
Breath of Fire II,25,2,3,30,0.9
Membrane,21,6,3,30,0.9
KURSK,10,26,4,40,0.9
SEASON: A letter to the future,43,20,7,70,0.9
Tenchu: Shadow Assassins,40,14,6,60,0.9
Mercenaries: Playground of Destruction,66,6,8,80,0.9
SPACECOM,21,6,3,30,0.9
BlazeRush,38,7,5,50,0.9
Pit People,63,9,8,80,0.9
Lords of the Realm II,33,3,4,40,0.9
Colossal Cave,18,9,3,30,0.9
Paper Beast,31,5,4,40,0.9
Risk of Rain 2,333,36,41,410,0.9
The Polar Express,11,16,3,30,0.9
Second Life,13,14,3,30,0.9
MIB: Alien Crisis,8,37,5,50,0.9
Champions of Regnum,12,15,3,30,0.9
Empires: Dawn of the Modern World,32,4,4,40,0.9
Castle In The Darkness,22,5,3,30,0.9
Luigi's Mansion 3,1179,88,141,1408,0.8998579545454546
Star Fox 64,262,7,30,299,0.8996655518394648
Guacamelee!,358,45,45,448,0.8995535714285714
NHL 21,34,163,22,219,0.8995433789954338
Finding Paradise,169,19,21,209,0.8995215311004785
Five Nights at Freddy's: Help Wanted,155,33,21,209,0.8995215311004785
Rune Factory 4,194,29,25,248,0.8991935483870968
Resident Evil 7: biohazard,5483,721,696,6900,0.8991304347826087
The King of Fighters XV,136,51,21,208,0.8990384615384616
Tales from the Borderlands: A Telltale Game Series,1236,108,151,1495,0.8989966555183947
Hatsune Miku: Project Mirai DX,80,9,10,99,0.898989898989899
LocoRoco 2,68,12,9,89,0.898876404494382
Spyro: Year of the Dragon,370,12,43,425,0.8988235294117647
Persona 5 Strikers,660,104,86,850,0.8988235294117647
Redfall,365,1260,183,1808,0.8987831858407079
Company of Heroes,979,51,116,1146,0.8987783595113438
Atelier Lulua: The Scion of Arland,52,19,8,79,0.8987341772151899
Rabi-Ribi,59,12,8,79,0.8987341772151899
Arslan: The Warriors of Legend,52,19,8,79,0.8987341772151899
Castlevania: Order of Ecclesia,123,10,15,148,0.8986486486486487
"Gremlins, Inc.",37,25,7,69,0.8985507246376812
Don't Starve: Giant Edition,56,6,7,69,0.8985507246376812
Baldur's Gate and Baldur's Gate II: Enhanced Editions,41,21,7,69,0.8985507246376812
The Walking Dead: Season Two Episode 5 - No Going Back,479,79,63,621,0.8985507246376812
Final Fantasy III Pixel Remaster,27,35,7,69,0.8985507246376812
Jak and Daxter: The Precursor Legacy,577,25,68,670,0.8985074626865671
Mario Kart DS,672,18,78,768,0.8984375
Anima: Gate of Memories,89,26,13,128,0.8984375
Triangle Strategy,322,58,43,423,0.8983451536643026
Beyond Good & Evil,459,27,55,541,0.8983364140480592
A Plague Tale: Requiem,1606,161,200,1967,0.8983223182511438
Fibbage: The Hilarious Bluffing Party Game,42,11,6,59,0.8983050847457628
Gex: Enter the Gecko,50,3,6,59,0.8983050847457628
Mega Man Zero 4,46,7,6,59,0.8983050847457628
Guns of Icarus,17,36,6,59,0.8983050847457628
Darkest Hour: A Hearts of Iron Game,47,6,6,59,0.8983050847457628
Final Fantasy XII: The Zodiac Age,957,128,123,1208,0.8981788079470199
Grand Theft Auto: Episodes from Liberty City,348,31,43,422,0.8981042654028436
Unsighted,110,31,16,157,0.8980891719745223
Wolfenstein: Youngblood,287,1281,178,1746,0.8980526918671249
Avatar: Frontiers of Pandora,476,114,67,657,0.898021308980213
Nioh: Dragon of the North,73,15,10,98,0.8979591836734694
Yomawari: Midnight Shadows,37,7,5,49,0.8979591836734694
The Alliance Alive,36,8,5,49,0.8979591836734694
Shadows of Adam,35,9,5,49,0.8979591836734694
AO Tennis 2,135,76,24,235,0.8978723404255319
Life is Strange: Episode 5 - Polarized,677,96,88,861,0.8977932636469221
Valentino Rossi The Game,58,21,9,88,0.8977272727272727
Hitman 3,1212,235,165,1612,0.8976426799007444
Metro Exodus: Enhanced Edition,480,37,59,576,0.8975694444444444
Donkey Kong Country 3: Dixie Kong's Double Trouble!,32,3,4,39,0.8974358974358975
Last Year: The Nightmare,17,18,4,39,0.8974358974358975
Shadow Tactics: Blades of the Shogun - Aiko's Choice,32,3,4,39,0.8974358974358975
Dragon Age: Origins - Ultimate Edition,97,8,12,117,0.8974358974358975
Call of Duty: Infinite Warfare - Legacy Pro Edition,9,26,4,39,0.8974358974358975
Naruto Shippuden: Ultimate Ninja Storm Legacy,28,7,4,39,0.8974358974358975
Nelly Cootalot: The Fowl Fleet,28,7,4,39,0.8974358974358975
Shadow Complex,100,5,12,117,0.8974358974358975
Persona 2: Innocent Sin,161,154,36,351,0.8974358974358975
Battlefield 2142: Northern Strike,29,6,4,39,0.8974358974358975
Old World,53,17,8,78,0.8974358974358975
Shing!,28,7,4,39,0.8974358974358975
Shovel Knight,1389,220,184,1793,0.8973786949247072
Metro: Last Light,3732,338,466,4536,0.8972663139329806
Ratchet & Clank,472,17,56,545,0.8972477064220183
Ghostbusters: Spirits Unleashed,49,12,7,68,0.8970588235294118
Thronebreaker: The Witcher Tales,792,157,109,1058,0.8969754253308129
The Elder Scrolls IV: Shivering Isles,276,20,34,330,0.896969696969697
Quake II,255,6,30,291,0.8969072164948454
Story of Seasons: Friends of Mineral Town,72,15,10,97,0.8969072164948454
Naraka: Bladepoint,74,39,13,126,0.8968253968253969
ARK: Survival Evolved - Genesis,11,41,6,58,0.896551724137931
Pitfall: The Lost Expedition,43,9,6,58,0.896551724137931
Minecraft: Story Mode Season Two - Episode 3: Jailhouse Block,39,13,6,58,0.896551724137931
Armored Core: For Answer,40,12,6,58,0.896551724137931
Destiny: The Taken King - Legendary Edition,40,38,9,87,0.896551724137931
Garfield Kart: Furious Racing,59,19,9,87,0.896551724137931
Wild West Online,7,45,6,58,0.896551724137931
ArcheAge,204,489,80,773,0.8965071151358344
Baldur's Gate II: Enhanced Edition,318,97,48,463,0.896328293736501
Jagged Alliance 3,109,12,14,135,0.8962962962962963
War Thunder,824,1724,295,2843,0.8962363700316567
Rugby 15,26,69,11,106,0.8962264150943396
Disciples II: Rise of the Elves,89,6,11,106,0.8962264150943396
Blaster Master Zero II,85,10,11,106,0.8962264150943396
Animal Crossing,135,3,16,154,0.8961038961038961
Life is Strange 2: Episode 1 - Roads,207,138,40,385,0.8961038961038961
Rise of Flight: The First Great Air War,57,12,8,77,0.8961038961038961
CrossfireX,79,240,37,356,0.8960674157303371
Devil May Cry 5: Special Edition,502,58,65,625,0.896
Warcraft II: Beyond the Dark Portal,110,2,13,125,0.896
Commandos 2: Men of Courage,254,13,31,298,0.8959731543624161
Dying Light: The Following - Enhanced Edition,825,70,104,999,0.8958958958958959
Snow Moto Racing Freedom,28,15,5,48,0.8958333333333334
Pursuit Force,37,6,5,48,0.8958333333333334
Dead Man's Hand,77,52,15,144,0.8958333333333334
Inazuma Eleven,76,10,10,96,0.8958333333333334
Bravely Second: End Layer,164,25,22,211,0.8957345971563981
Need for Speed: Underground 2,1038,44,126,1208,0.8956953642384106
BlazBlue: Chrono Phantasma Extend,85,18,12,115,0.8956521739130435
R-Type Final 2,25,35,7,67,0.8955223880597015
Nowhere Prophet,40,20,7,67,0.8955223880597015
MLB 10: The Show,39,21,7,67,0.8955223880597015
PaRappa the Rapper 2,49,11,7,67,0.8955223880597015
Legacy of Kain: Defiance,144,10,18,172,0.8953488372093024
Donkey Kong Country,74,3,9,86,0.8953488372093024
Zoo Tycoon,88,297,45,430,0.8953488372093024
Dark Souls II: Crown of the Ivory King,192,39,27,258,0.8953488372093024
Romance of the Three Kingdoms XIV: Diplomacy and Strategy Expansion Pack Bundle,73,4,9,86,0.8953488372093024
The Bard's Tale IV: Barrows Deep,60,34,11,105,0.8952380952380953
SOMA,1767,155,225,2147,0.8952026082906381
Diablo,1205,58,148,1411,0.8951098511693835
Amnesia: The Dark Descent,1398,68,172,1638,0.894993894993895
Destiny 2: Forsaken,369,219,69,657,0.8949771689497716
Final Fantasy XI: Treasures of Aht Urhgan,25,9,4,38,0.8947368421052632
Ys: The Ark of Napishtim,80,5,10,95,0.8947368421052632
BRAWL,52,33,10,95,0.8947368421052632
No One Lives Forever 2: A Spy in H.A.R.M.'s Way,200,4,24,228,0.8947368421052632
Marvel's Iron Man VR,95,58,18,171,0.8947368421052632
Laser League,36,15,6,57,0.8947368421052632
Conker: Live & Reloaded,63,5,8,76,0.8947368421052632
Vendetta: Curse of Raven's Cry,13,21,4,38,0.8947368421052632
Niko: Through The Dream,28,6,4,38,0.8947368421052632
Cube World (2019),5,46,6,57,0.8947368421052632
River City Girls 2,21,13,4,38,0.8947368421052632
World Soccer Winning Eleven 7 International,61,24,10,95,0.8947368421052632
Slain!,16,18,4,38,0.8947368421052632
Ace Combat 2,49,2,6,57,0.8947368421052632
World End Syndrome,30,4,4,38,0.8947368421052632
Gwent: The Witcher Card Game,375,160,63,598,0.8946488294314381
Starpoint Gemini 2,141,20,19,180,0.8944444444444445
The Talos Principle: Deluxe Edition,242,29,32,303,0.8943894389438944
Tales From The Borderlands: Episode 3 - Catch A Ride,210,44,30,284,0.8943661971830986
Mario Kart: Double Dash!!,413,10,50,473,0.8942917547568711
Giants: Citizen Kabuto,84,9,11,104,0.8942307692307693
Takedown: Red Sabre,34,135,20,189,0.8941798941798942
Project CARS 3,68,168,28,264,0.8939393939393939
Pinball FX 2,135,25,19,179,0.8938547486033519
Duck Game,139,21,19,179,0.8938547486033519
Hotline Miami,2409,141,303,2853,0.8937960042060988
Metal Gear Solid 2: Substance,249,20,32,301,0.893687707641196
Ion Fury,225,86,37,348,0.8936781609195402
Meteos,37,5,5,47,0.8936170212765957
Lost in Play,37,5,5,47,0.8936170212765957
Epic Battle Fantasy 4,37,5,5,47,0.8936170212765957
Alexander,39,3,5,47,0.8936170212765957
Capcom Fighting Collection,23,19,5,47,0.8936170212765957
Combat Mission: Battle for Normandy,23,19,5,47,0.8936170212765957
Lacuna - A Sci-Fi Noir Adventure,33,9,5,47,0.8936170212765957
Terraria,3125,242,401,3768,0.8935774946921444
Assassin's Creed II,5306,219,659,6184,0.8934346701164295
Scourge: Outbreak,46,21,8,75,0.8933333333333333
The Talos Principle: Road To Gehenna,60,7,8,75,0.8933333333333333
Persona Q: Shadow of the Labyrinth,214,171,46,431,0.8932714617169374
Dead or Alive Xtreme 3,125,34,19,178,0.8932584269662921
BioShock Infinite,12166,989,1572,14727,0.8932572825422693
Elite Dangerous: Horizons,47,45,11,103,0.8932038834951457
World of Warcraft: Legion,1122,249,164,1535,0.8931596091205212
Trover Saves the Universe,100,17,14,131,0.8931297709923665
Star Trek The Video Game,101,651,90,842,0.8931116389548693
Colin McRae Rally 2.0,163,4,20,187,0.893048128342246
New World,454,414,104,972,0.8930041152263375
EA Sports FC 24,109,658,92,859,0.8928987194412107
RollerCoaster Tycoon 3: Wild!,26,24,6,56,0.8928571428571429
Virtua Fighter 5 Final Showdown,88,37,15,140,0.8928571428571429
Azure Striker Gunvolt: Striker Pack,44,6,6,56,0.8928571428571429
Unreal Tournament 2004,601,23,75,699,0.8927038626609443
Kirby Air Ride,96,12,13,121,0.8925619834710744
Natural Selection 2,522,51,69,642,0.8925233644859814
Star Wars: Empire at War: Forces of Corruption,78,5,10,93,0.8924731182795699
NFL 2K1,50,33,10,93,0.8924731182795699
The Walking Dead: Season Two Episode 3 - In Harm's Way,345,53,48,446,0.8923766816143498
Toukiden,104,12,14,130,0.8923076923076924
Minecraft: Story Mode - Episode 6: A Portal to Mystery,41,17,7,65,0.8923076923076924
Shadow Fight 2,42,16,7,65,0.8923076923076924
Endzone: A World Apart,142,7,18,167,0.8922155688622755
Pokemon Alpha Sapphire,646,132,94,872,0.8922018348623854
Chroma Squad,101,23,15,139,0.8920863309352518
Halo: Reach,2560,232,338,3130,0.8920127795527156
Cognition: An Erica Reed Thriller Episode 3 - The Oracle,27,6,4,37,0.8918918918918919
Star Wars Battlefront: Death Star,11,22,4,37,0.8918918918918919
Mugen Souls Z,23,10,4,37,0.8918918918918919
Far Cry 4: Escape from Durgesh Prison,20,13,4,37,0.8918918918918919
Dreamfall Chapters Book Three: Realms,23,10,4,37,0.8918918918918919
Zenith (2016),24,9,4,37,0.8918918918918919
In Other Waters,20,13,4,37,0.8918918918918919
Dragon Quest Heroes II,76,23,12,111,0.8918918918918919
Rusty Lake: Roots,29,4,4,37,0.8918918918918919
Grindstone,24,9,4,37,0.8918918918918919
Realms of Arkania: Blade of Destiny,17,49,8,74,0.8918918918918919
Agatha Knife,25,8,4,37,0.8918918918918919
Wargame: AirLand Battle,209,30,29,268,0.8917910447761194
RACE 07: Official WTCC Game,62,12,9,83,0.891566265060241
Sid Meier's Civilization II,391,28,51,470,0.8914893617021277
Final Fantasy: The 4 Heroes of Light,104,11,14,129,0.8914728682170543
"Warhammer 40,000: Dawn of War",343,10,43,396,0.8914141414141414
Planet Coaster,384,100,59,543,0.8913443830570903
Tom Clancy's Splinter Cell: Chaos Theory,769,43,99,911,0.8913282107574094
Odallus: The Dark Call,36,5,5,46,0.8913043478260869
Descent II,40,1,5,46,0.8913043478260869
Perimeter,36,5,5,46,0.8913043478260869
Kirby & the Amazing Mirror,79,3,10,92,0.8913043478260869
Fallout 3: Game of the Year Edition,146,18,20,184,0.8913043478260869
The Golf Club,105,67,21,193,0.8911917098445595
Battlefield V,1465,5004,790,7259,0.8911695825871332
Star Ocean: The Divine Force,152,110,32,294,0.891156462585034
The Wolf Among Us: Episode 3 - A Crooked Mile,356,45,49,450,0.8911111111111111
Tokyo Xanadu eX+,77,13,11,101,0.8910891089108911
Deltarune: Chapter 1,256,22,34,312,0.8910256410256411
Star Wars Jedi Knight: Dark Forces II,184,4,23,211,0.8909952606635071
Disgaea 3: Absence of Justice,170,18,23,211,0.8909952606635071
The Last Guardian,2084,417,306,2807,0.8909868186676166
Insurgency: Sandstorm,237,49,35,321,0.8909657320872274
Bleach: Shattered Blade,30,19,6,55,0.8909090909090909
Hidden & Dangerous 2,46,3,6,55,0.8909090909090909
Robotics;Notes Elite,44,5,6,55,0.8909090909090909
New Super Mario Bros. U + New Super Luigi U,46,3,6,55,0.8909090909090909
TROUBLESHOOTER: Abandoned Children,46,3,6,55,0.8909090909090909
Warface: Breakout,71,27,12,110,0.8909090909090909
Call of Duty: Vanguard,770,1761,310,2841,0.8908834917282646
SteamWorld Dig 2,468,38,62,568,0.8908450704225352
Dark Souls II: Crown of the Old Iron King,201,52,31,284,0.8908450704225352
Inscryption,471,43,63,577,0.8908145580589255
The Legend of Zelda: Link's Awakening,1492,107,196,1795,0.8908077994428969
The Longest Journey,416,24,54,494,0.8906882591093117
Life is Strange: Episode 1 - Chrysalis,966,101,131,1198,0.8906510851419032
The Sojourn,37,20,7,64,0.890625
Final Fantasy II Pixel Remaster,21,36,7,64,0.890625
Sid Meier's Civilization V: The Complete Edition,54,3,7,64,0.890625
Pokemon LeafGreen Version,218,18,29,265,0.8905660377358491
Sonic Superstars,625,42,82,749,0.890520694259012
Live A Live,95,27,15,137,0.8905109489051095
Total War: WARHAMMER II,475,78,68,621,0.8904991948470209
Samurai Shodown,103,27,16,146,0.8904109589041096
Fallout 4: Contraptions Workshop,19,54,9,82,0.8902439024390244
XCOM: Enemy Within Expansion,662,76,91,829,0.8902291917973462
Medal of Honor: Allied Assault,512,23,66,601,0.8901830282861897
Europa Universalis III,156,6,20,182,0.8901098901098901
Rocksmith,140,22,20,182,0.8901098901098901
Goodbye Volcano High,59,22,10,91,0.8901098901098901
In Sound Mind,72,9,10,91,0.8901098901098901
Freedom Wars,241,26,33,300,0.89
Assetto Corsa,456,94,68,618,0.889967637540453
"Warhammer 40,000: Dawn of War - Dark Crusade",291,8,37,336,0.8898809523809523
New Pokemon Snap,440,158,74,672,0.8898809523809523
Mega Man X5,92,13,13,118,0.8898305084745762
Rebel Galaxy Outlaw,64,65,16,145,0.8896551724137931
Mega Man 9,97,32,16,145,0.8896551724137931
Dissidia 012: Duodecim Final Fantasy,232,34,33,299,0.8896321070234113
Cyberpunk 2077: Phantom Liberty,1468,514,246,2228,0.8895870736086176
Battle Brothers,127,18,18,163,0.8895705521472392
Rock Band 2,139,22,20,181,0.8895027624309392
Perfect Dark (2000),470,45,64,579,0.8894645941278065
Digimon Story Cyber Sleuth: Hacker's Memory,141,52,24,217,0.8894009216589862
Disgaea: Afternoon of Darkness,153,48,25,226,0.8893805309734514
Hearts of Iron II,67,5,9,81,0.8888888888888888
Atlas Reactor,37,11,6,54,0.8888888888888888
Mortal Kombat: Special Forces,7,25,4,36,0.8888888888888888
American Conquest,33,7,5,45,0.8888888888888888
428: Shibuya Scramble,41,7,6,54,0.8888888888888888
Curse of the Sea Rats,6,34,5,45,0.8888888888888888
Space Invaders Extreme,35,5,5,45,0.8888888888888888
Atelier Totori: The Adventurer of Arland,112,16,16,144,0.8888888888888888
Titan Quest: Gold Edition,31,1,4,36,0.8888888888888888
Rugby League Live 3,22,10,4,36,0.8888888888888888
Bombshell (2016),27,61,11,99,0.8888888888888888
Call of Duty: Modern Warfare 2 - Resurgence Pack,9,39,6,54,0.8888888888888888
Rise of Nations: Thrones & Patriots,93,3,12,108,0.8888888888888888
Guilty Gear X2 #Reload,26,6,4,36,0.8888888888888888
Train Simulator 2014,33,47,10,90,0.8888888888888888
Atelier Firis: The Alchemist and the Mysterious Journey,48,16,8,72,0.8888888888888888
Patrician III: Rise of the Hanse,38,2,5,45,0.8888888888888888
Arcana Heart 3: LOVE MAX!!!!!,23,9,4,36,0.8888888888888888
Maldita Castilla EX: Cursed Castilla,77,19,12,108,0.8888888888888888
Final Fantasy XVI: Echoes of the Fallen,20,12,4,36,0.8888888888888888
Fallout: Brotherhood of Steel,20,20,5,45,0.8888888888888888
City of Heroes,37,3,5,45,0.8888888888888888
Chess Ultra,23,17,5,45,0.8888888888888888
PixARK,26,22,6,54,0.8888888888888888
RoboCop: Rogue City,281,15,37,333,0.8888888888888888
Earth Defense Force: World Brothers,222,18,30,270,0.8888888888888888
The Elder Scrolls V: Skyrim Special Edition,2355,457,352,3164,0.888748419721871
EA SPORTS UFC 4,68,553,78,699,0.8884120171673819
Resident Evil: Revelations 2 - Episode 2: Contemplation,113,38,19,170,0.888235294117647
Cities: Skylines,2068,140,278,2486,0.8881737731295254
Muramasa: The Demon Blade,238,24,33,295,0.888135593220339
Crackdown 3,401,766,147,1314,0.8881278538812786
Quake III Arena,369,12,48,429,0.8881118881118881
Sid Meier's Alpha Centauri,195,19,27,241,0.8879668049792531
Little Nightmares II,877,82,121,1080,0.887962962962963
Disgaea 2: Dark Hero Days,78,17,12,107,0.8878504672897196
Soul Reaver 2,151,7,20,178,0.8876404494382022
Wario Land 4,77,2,10,89,0.8876404494382022
The Playroom VR,60,11,9,80,0.8875
Euro Truck Simulator 2,1392,74,186,1652,0.887409200968523
Gran Turismo 3: A-Spec,309,22,42,373,0.8873994638069705
Tom Clancy's The Division 2,1809,1524,423,3756,0.8873801916932907
Disgaea D2: A Brighter Darkness,51,12,8,71,0.8873239436619719
Kirby: Triple Deluxe,304,11,40,355,0.8873239436619719
SoulCalibur III,114,4,15,133,0.8872180451127819
Prey,2838,353,406,3597,0.8871281623575201
"Warhammer 40,000: Eternal Crusade",22,33,7,62,0.8870967741935484
VA-11 Hall-A: Cyberpunk Bartender Action,282,48,42,372,0.8870967741935484
Bleeding Edge,384,268,83,735,0.8870748299319728
Super Mario Maker,888,86,124,1098,0.8870673952641166
Insurgency,525,48,73,646,0.8869969040247678
Street Fighter V,478,1271,223,1972,0.8869168356997972
Dragon Quest Builders,309,36,44,389,0.8868894601542416
Gravity Rush,631,35,85,751,0.8868175765645806
Doraemon: Story of Seasons,35,12,6,53,0.8867924528301887
Noita,81,13,12,106,0.8867924528301887
Final Fantasy Crystal Chronicles: The Crystal Bearers,126,15,18,159,0.8867924528301887
Counter-Strike,1490,131,207,1828,0.8867614879649891
King's Bounty II,109,118,29,256,0.88671875
Divinity: Original Sin Enhanced Edition,1130,169,166,1465,0.8866894197952219
Dead Space 2,2684,123,359,3166,0.8866077068856602
Hotel Dusk: Room 215,82,4,11,97,0.8865979381443299
Neverwinter Nights 2: Mask of The Betrayer,151,13,21,185,0.8864864864864865
Shadowverse,22,17,5,44,0.8863636363636364
E.T. Armies,28,11,5,44,0.8863636363636364
Fantastic Four: Rise of the Silver Surfer,23,16,5,44,0.8863636363636364
EVE Online: Special Edition,145,50,25,220,0.8863636363636364
Lone Echo,66,12,10,88,0.8863636363636364
We Are The Dwarves,27,12,5,44,0.8863636363636364
Pinball FX 2: Star Wars Pinball,26,13,5,44,0.8863636363636364
Order of Battle: Pacific,23,16,5,44,0.8863636363636364
Pillars of Eternity: The White March - Part 2,118,30,19,167,0.8862275449101796
Sonic 3 & Knuckles,67,3,9,79,0.8860759493670886
Shin Megami Tensei III: Nocturne HD Remaster,115,25,18,158,0.8860759493670886
The Walking Dead: The Telltale Series - The Final Season Episode 1: Done Running,143,28,22,193,0.8860103626943006
World of Warships: Legends,73,28,13,114,0.8859649122807017
Ys Seven,91,10,13,114,0.8859649122807017
Dungeons of Sundaria,22,9,4,35,0.8857142857142857
Barbie in The 12 Dancing Princesses,26,5,4,35,0.8857142857142857
Age of Wushu,32,30,8,70,0.8857142857142857
Tangledeep,26,5,4,35,0.8857142857142857
Rune Factory Frontier,29,2,4,35,0.8857142857142857
Champions: Return to Arms,25,6,4,35,0.8857142857142857
Riven: The Sequel to Myst,26,5,4,35,0.8857142857142857
Crusader Kings III,639,66,91,796,0.885678391959799
Chaos on Deponia,220,20,31,271,0.8856088560885609
TimeSplitters 2,191,18,27,236,0.885593220338983
NiGHTS into Dreams... (2012),72,13,11,96,0.8854166666666666
Crash Team Racing: Nitro-Fueled,795,340,147,1282,0.8853354134165367
Dragon's Crown,508,71,75,654,0.8853211009174312
Cartoon Network: Battle Crashers,8,46,7,61,0.8852459016393442
Flipnote Studio,39,15,7,61,0.8852459016393442
Minecraft: Story Mode Season Two - Episode 1: Hero in Residence,48,60,14,122,0.8852459016393442
Armored Core VI: Fires of Rubicon,1256,202,189,1647,0.8852459016393442
Sea of Stars,930,165,142,1237,0.8852061438965239
Call of Duty: Modern Warfare 3,5070,13074,2356,20500,0.8850731707317073
Toy Soldiers,131,23,20,174,0.8850574712643678
Resident Evil 5: Gold Edition,139,15,20,174,0.8850574712643678
Stronghold 3,53,278,43,374,0.8850267379679144
Life is Strange: Before the Storm - Episode 1: Awake,247,68,41,356,0.8848314606741573
Deadly Premonition,465,95,73,633,0.8846761453396524
World Soccer Winning Eleven 8 International,34,12,6,52,0.8846153846153846
Fallout 4 VR,33,36,9,78,0.8846153846153846
Wizardry Online,25,21,6,52,0.8846153846153846
Capcom vs. SNK 2,42,4,6,52,0.8846153846153846
TxK,52,17,9,78,0.8846153846153846
Shovel Knight: King of Cards,39,7,6,52,0.8846153846153846
X-COM: Apocalypse,44,2,6,52,0.8846153846153846
Horizon Call of the Mountain,104,34,18,156,0.8846153846153846
Destiny 2: Beyond Light,125,174,39,338,0.8846153846153846
No Man's Sky,3365,4386,1012,8763,0.884514435695538
Batman: Arkham Knight,5952,2119,1054,9125,0.8844931506849315
LittleBigPlanet 2,712,38,98,848,0.8844339622641509
Magic: Duels of the Planeswalkers 2015,51,125,23,199,0.8844221105527639
Knack 2,395,87,63,545,0.8844036697247707
Sniper Ghost Warrior Contracts 2,154,52,27,233,0.8841201716738197
Bloodstained: Ritual of the Night,934,195,148,1277,0.8841033672670321
Postal 2: Share the Pain,213,31,32,276,0.8840579710144928
Fire Emblem: Three Houses - Side Story: Cindered Shadows,54,7,8,69,0.8840579710144928
Tetris 99,255,27,37,319,0.8840125391849529
NBA 2K11,233,26,34,293,0.8839590443686007
Wandersong,84,15,13,112,0.8839285714285714
Marvel vs. Capcom 2,184,14,26,224,0.8839285714285714
World of Warships,209,164,49,422,0.8838862559241706
F1 2020,342,69,54,465,0.8838709677419355
Mega Man Battle Network,29,9,5,43,0.8837209302325582
SoulCalibur II HD Online,34,4,5,43,0.8837209302325582
Tennis World Tour,28,124,20,172,0.8837209302325582
Final Fantasy Pixel Remaster,64,50,15,129,0.8837209302325582
PlayStation Portable,32,6,5,43,0.8837209302325582
Pier Solar and the Great Architects,49,27,10,86,0.8837209302325582
Pokemon Scarlet / Pokemon Violet: The Hidden Treasure of Area Zero - Part 2: The Indigo Disk,12,26,5,43,0.8837209302325582
Drakengard,107,22,17,146,0.8835616438356164
Brothers: A Tale of Two Sons,2188,179,312,2679,0.883538633818589
Sonic & All-Stars Racing Transformed,762,87,112,961,0.8834547346514048
SoulCalibur II,295,8,40,343,0.8833819241982507
Katamari Damacy REROLL,128,31,21,180,0.8833333333333333
Phoenix Wright: Ace Attorney - Dual Destinies,230,35,35,300,0.8833333333333333
Project X Zone 2,42,11,7,60,0.8833333333333333
Red Dead Redemption: Undead Nightmare,47,6,7,60,0.8833333333333333
Yo-kai Watch 2: Fleshy Souls,45,8,7,60,0.8833333333333333
Plants vs. Zombies,1503,56,206,1765,0.88328611898017
Guitar Hero: Metallica,108,13,16,137,0.8832116788321168
Pillars of Eternity,2125,272,317,2714,0.8831982313927782
Hogwarts Legacy,5416,685,807,6908,0.8831789229878402
Rayman Origins,1420,137,206,1763,0.8831537152580828
Sunset Overdrive,1275,229,199,1703,0.8831473869641808
Path of Exile,1749,344,277,2370,0.8831223628691983
Tenchu 2: Birth of the Stealth Assassins,65,3,9,77,0.8831168831168831
The Yakuza Remastered Collection,60,8,9,77,0.8831168831168831
Ascend: Hand of Kul,178,41,29,248,0.8830645161290323
Pathfinder: Wrath of the Righteous,285,85,49,419,0.883054892601432
Dragon Fin Soup,39,44,11,94,0.8829787234042553
Alundra,77,6,11,94,0.8829787234042553
Forza Motorsport 3,360,32,52,444,0.8828828828828829
Bravely Default,563,55,82,700,0.8828571428571429
The Walking Dead: The Telltale Series - The Final Season Episode 4: Take Us Back,119,24,19,162,0.8827160493827161
Valorant,1535,2009,472,4016,0.8824701195219123
INSIDE,2969,219,425,3613,0.8823692222529753
Ravaged: Zombie Apocalypse,3,27,4,34,0.8823529411764706
Sunset (2015),14,46,8,68,0.8823529411764706
Dragon Quest Monsters: The Dark Prince,66,9,10,85,0.8823529411764706
Beyond Good & Evil HD,190,5,26,221,0.8823529411764706
Dead or Alive Xtreme 2,22,8,4,34,0.8823529411764706
Story of Seasons: Trio of Towns,37,8,6,51,0.8823529411764706
Ar nosurge: Ode to an Unborn Star,78,12,12,102,0.8823529411764706
SpellForce 3: Soul Harvest,42,3,6,51,0.8823529411764706
Dragon Ball Z: Kakarot + A New Power Awakens Set,24,6,4,34,0.8823529411764706
SUCCUBUS,21,9,4,34,0.8823529411764706
Farpoint,197,28,30,255,0.8823529411764706
Shape Up,24,6,4,34,0.8823529411764706
Need for Speed: Rivals - Complete Edition,63,12,10,85,0.8823529411764706
Digimon Digital Card Battle,27,3,4,34,0.8823529411764706
Middle-earth: Shadow of Mordor - Game of the Year Edition,96,9,14,119,0.8823529411764706
Advance Wars: Dual Strike,114,6,16,136,0.8823529411764706
SimCity 4: Deluxe Edition,43,2,6,51,0.8823529411764706
NASCAR Racing 2003 Season,24,6,4,34,0.8823529411764706
STASIS: BONE TOTEM,37,8,6,51,0.8823529411764706
Pokemon Black Version 2,522,85,81,688,0.8822674418604651
A Plague Tale: Innocence,3545,224,503,4272,0.8822565543071161
Elite: Dangerous,1322,625,260,2207,0.8821930222020843
The Ascent,717,159,117,993,0.8821752265861027
The Evil Within,4752,761,737,6250,0.88208
SpaceChem,145,12,21,178,0.8820224719101124
Syberia: The World Before,128,14,19,161,0.8819875776397516
Baldo: The Guardian Owls,62,65,17,144,0.8819444444444444
Command & Conquer: Red Alert,369,12,51,432,0.8819444444444444
Captain Toad: Treasure Tracker,671,61,98,830,0.8819277108433735
Goodbye Deponia,207,32,32,271,0.8819188191881919
Dream Daddy: A Dad Dating Simulator,85,27,15,127,0.8818897637795275
Jeanne d'Arc,93,4,13,110,0.8818181818181818
Kirby's Return to Dream Land Deluxe,93,4,13,110,0.8818181818181818
The Fight: Lights Out,60,7,9,76,0.881578947368421
FOX n FORESTS,51,16,9,76,0.881578947368421
Immortal: Unchained,86,48,18,152,0.881578947368421
1001 Spikes,77,42,16,135,0.8814814814814815
Remothered: Broken Porcelain,80,39,16,135,0.8814814814814815
Medieval II: Total War Kingdoms,170,1,23,194,0.8814432989690721
Rock Band 3,233,42,37,312,0.8814102564102564
Digimon Rumble Arena,49,3,7,59,0.8813559322033898
Pokemon FireRed Version,522,20,73,615,0.8813008130081301
Myth: The Fallen Lords,83,6,12,101,0.8811881188118812
Pokemon Conquest,114,12,17,143,0.8811188811188811
Prey: Mooncrash,153,47,27,227,0.8810572687224669
TrackMania Sunrise,29,8,5,42,0.8809523809523809
Etrian Odyssey V: Beyond the Myth,33,4,5,42,0.8809523809523809
Mafia III: Definitive Edition,209,50,35,294,0.8809523809523809
Little Witch Academia: Chamber of Time,26,11,5,42,0.8809523809523809
Wipeout 3,34,3,5,42,0.8809523809523809
ARK: Survival Evolved - Aberration,30,7,5,42,0.8809523809523809
Planetary Annihilation: TITANS,44,30,10,84,0.8809523809523809
Disgaea 5: Alliance of Vengeance,313,42,48,403,0.8808933002481389
NBA 2K22,96,244,46,386,0.8808290155440415
TERA: Rising,43,16,8,67,0.8805970149253731
Legends of Dawn,21,38,8,67,0.8805970149253731
Mario Tennis,137,3,19,159,0.8805031446540881
XCOM: Enemy Unknown,2888,302,433,3623,0.8804857852608335
Fable: The Journey,36,45,11,92,0.8804347826086957
The Banner Saga: Factions,86,17,14,117,0.8803418803418803
Super Mega Baseball,81,22,14,117,0.8803418803418803
Ragnarok Online,92,11,14,117,0.8803418803418803
NBA 2K24,22,206,31,259,0.8803088803088803
Kingdom Hearts III,2312,460,377,3149,0.8802794537948555
Gears of War 3,1657,188,251,2096,0.8802480916030534
Green Hell,205,52,35,292,0.8801369863013698
Nickelodeon Drake & Josh: Talent Showdown,43,1,6,50,0.88
Half-Life 2: Episode One,1490,35,208,1733,0.8799769186381996
Metro Exodus,5139,1471,902,7512,0.8799254526091587
Command & Conquer 4: Tiberian Twilight,22,227,34,283,0.8798586572438163
Tony Hawk's Underground,147,14,22,183,0.8797814207650273
Ever Oasis,84,11,13,108,0.8796296296296297
DUSK,241,22,36,299,0.8795986622073578
Deus Ex: Human Revolution,4596,291,669,5556,0.8795896328293736
Patapon 2 Remastered,48,25,10,83,0.8795180722891566
Prince of Persia: Warrior Within,692,38,100,830,0.8795180722891566
Contra: Rogue Corps,52,94,20,166,0.8795180722891566
Anno 1800,355,61,57,473,0.879492600422833
Borderlands: The Pre-Sequel - Claptastic Voyage and Ultimate Vault Hunter Upgrade Pack 2,29,22,7,58,0.8793103448275862
Pokemon Omega Ruby,771,161,128,1060,0.879245283018868
S.T.A.L.K.E.R.: Shadow of Chernobyl,1214,96,180,1490,0.8791946308724832
Rez Infinite,182,58,33,273,0.8791208791208791
Splatoon 3,357,123,66,546,0.8791208791208791
Dead Cells: Return to Castlevania,66,14,11,91,0.8791208791208791
Starcraft II: Wings of Liberty,2218,253,340,2811,0.8790466026325151
Assassin's Creed: The Rebel Collection,94,15,15,124,0.8790322580645161
Dragon's Dogma: Dark Arisen,1219,176,192,1587,0.8790170132325141
FIFA 19,301,1594,261,2156,0.8789424860853432
Guild Wars 2,2395,429,389,3213,0.8789293495175848
Animal Crossing: amiibo Festival,71,154,31,256,0.87890625
Metro Redux,1486,161,227,1874,0.8788687299893276
Faces of War,27,2,4,33,0.8787878787878788
Call of Duty: Black Ops III - Zombies Chronicles,41,17,8,66,0.8787878787878788
Ninja Five-0,28,1,4,33,0.8787878787878788
Skyward Collapse,26,3,4,33,0.8787878787878788
Azure Striker Gunvolt 2,24,5,4,33,0.8787878787878788
Caravan Stories,10,19,4,33,0.8787878787878788
Atari 50: The Anniversary Celebration,23,6,4,33,0.8787878787878788
The Elder Scrolls Online: Elsweyr,43,15,8,66,0.8787878787878788
Banner of the Maid,27,2,4,33,0.8787878787878788
Medieval: Total War - Viking Invasion,27,2,4,33,0.8787878787878788
Earth Defense Force 2017 Portable,25,4,4,33,0.8787878787878788
Onimusha 2: Samurai's Destiny,83,4,12,99,0.8787878787878788
The Sims 4: Spa Day,22,7,4,33,0.8787878787878788
Rogue Heroes: Ruins of Tasos,26,3,4,33,0.8787878787878788
Medal of Honor Underground,107,9,16,132,0.8787878787878788
RollerCoaster Tycoon 2,114,2,16,132,0.8787878787878788
"Love, Money, Rock'n'Roll",35,23,8,66,0.8787878787878788
Oddworld: Munch's Oddysee HD,22,7,4,33,0.8787878787878788
Hyrule Warriors: Definitive Edition,180,30,29,239,0.8786610878661087
Mario Kart Wii,906,28,129,1063,0.878645343367827
Berserk and the Band of the Hawk,147,34,25,206,0.8786407766990292
Pokemon Super Mystery Dungeon,266,38,42,346,0.8786127167630058
Mortal Kombat (2011),1111,83,165,1359,0.8785871964679912
Nioh 2,893,149,144,1186,0.8785834738617201
The Elder Scrolls IV: Oblivion,4380,283,645,5308,0.8784853051996986
Elemental: War of Magic,34,31,9,74,0.8783783783783784
Hearthstone: Heroes of Warcraft - Whispers of the Old Gods,60,70,18,148,0.8783783783783784
Van Helsing I: Complete Pack,57,8,9,74,0.8783783783783784
Shadow Gambit: The Cursed Crew,50,15,9,74,0.8783783783783784
Outward,210,86,41,337,0.8783382789317508
Dying Light: The Following,422,47,65,534,0.8782771535580525
Killer Instinct: Definitive Edition,85,16,14,115,0.8782608695652174
Resident Evil: Revelations 2 - Extra Episode 2: Little Miss,28,8,5,41,0.8780487804878049
Lorelai,26,10,5,41,0.8780487804878049
Street Fighter: 30th Anniversary Collection,172,44,30,246,0.8780487804878049
Tools Up!,30,6,5,41,0.8780487804878049
Omen of Sorrow,32,40,10,82,0.8780487804878049
Tumble VR,30,6,5,41,0.8780487804878049
Mario + Rabbids: Kingdom Battle,1117,92,168,1377,0.8779956427015251
The Elder Scrolls V: Skyrim - Dragonborn,525,72,83,680,0.8779411764705882
The Sims 4: Cats & Dogs,34,45,11,90,0.8777777777777778
Star Wars Jedi Knight II: Jedi Outcast,484,33,72,589,0.8777589134125636
Baldur's Gate: Dark Alliance,185,16,28,229,0.8777292576419214
HuniePop,112,10,17,139,0.8776978417266187
Darkwood,213,31,34,278,0.8776978417266187
Gears 5: Hivebusters,172,36,29,237,0.8776371308016878
Resident Evil 0,284,10,41,335,0.8776119402985074
The Mercury Man,35,8,6,49,0.8775510204081632
Lux-Pain,33,10,6,49,0.8775510204081632
Tetris DS,35,8,6,49,0.8775510204081632
Ratchet & Clank Future: Tools of Destruction,422,15,61,498,0.8775100401606426
Tekken Tag Tournament 2,405,53,64,522,0.8773946360153256
Nintendo Labo: Toycon 01 Variety Kit,131,55,26,212,0.8773584905660378
Past Cure,44,49,13,106,0.8773584905660378
Nobunaga's Ambition: Sphere of Influence,75,18,13,106,0.8773584905660378
Thief: Deadly Shadows,220,16,33,269,0.8773234200743495
Far Cry 3,7183,461,1069,8713,0.8773097670148055
Assassin's Creed: The Ezio Collection,434,52,68,554,0.8772563176895307
Nioh: Defiant Honor,39,11,7,57,0.8771929824561403
ICO,429,28,64,521,0.8771593090211133
Ace Combat 7: Skies Unknown,559,112,94,765,0.8771241830065359
Children of Morta,432,53,68,553,0.8770343580470162
Super Mario RPG,145,19,23,187,0.8770053475935828
Vampire Survivors,519,44,79,642,0.8769470404984424
Doki Doki Literature Club!,683,51,103,837,0.8769414575866189
Honkai: Star Rail,149,79,32,260,0.8769230769230769
Wonder Boy: Asha in Monster World,37,20,8,65,0.8769230769230769
The Elder Scrolls: Blades,15,99,16,130,0.8769230769230769
Final Fantasy IV,54,3,8,65,0.8769230769230769
Hearthstone: Heroes of Warcraft - Journey to Un'Goro,20,37,8,65,0.8769230769230769
The Darkside Detective,54,3,8,65,0.8769230769230769
Squad,47,10,8,65,0.8769230769230769
Sudeki,51,6,8,65,0.8769230769230769
Tabletop Simulator,51,6,8,65,0.8769230769230769
FTL: Faster Than Light,1316,107,200,1623,0.8767714109673445
Street Fighter Alpha 3,118,10,18,146,0.8767123287671232
Sacrifice (2000),119,9,18,146,0.8767123287671232
MLB The Show 19,146,46,27,219,0.8767123287671232
X3: Terran Conflict,115,20,19,154,0.8766233766233766
Gran Turismo 6,758,130,125,1013,0.876604146100691
Furi,480,81,79,640,0.8765625
Pro Evolution Soccer 2017,595,328,130,1053,0.8765432098765432
Helltaker,212,15,32,259,0.8764478764478765
The Elder Scrolls Online: Greymoor,37,41,11,89,0.8764044943820225
Valkyria Chronicles II,72,6,11,89,0.8764044943820225
Fire Emblem: Radiant Dawn,225,9,33,267,0.8764044943820225
Quake II - Enhanced Edition,149,28,25,202,0.8762376237623762
Nioh: Complete Edition,559,99,93,751,0.8761651131824234
Bayonetta,1958,228,309,2495,0.8761523046092184
Control: Ultimate Edition,617,90,100,807,0.8760842627013631
Dungeons & Dragons: Dark Alliance,54,165,31,250,0.876
Until Dawn,3101,248,475,3824,0.8757845188284519
Keep Talking and Nobody Explodes,119,22,20,161,0.8757763975155279
Yoshi's Woolly World,446,40,69,555,0.8756756756756757
Streets of Rage 4,881,81,137,1099,0.8753412192902639
Crash Twinsanity,317,20,48,385,0.8753246753246753
Dishonored: Definitive Edition,638,56,99,793,0.8751576292559899
The Sims 3: Into the Future,23,19,6,48,0.875
War of the Monsters,37,5,6,48,0.875
Tales From The Borderlands: Episode 2 - Atlas Mugged,223,43,38,304,0.875
Age of Empires II: Gold Edition,60,3,9,72,0.875
Wargame: Red Dragon,158,31,27,216,0.875
The Sims Deluxe,50,6,8,64,0.875
The Ninja Saviors: Return of the Warriors,26,9,5,40,0.875
Youtubers Life: OMG Edition,24,11,5,40,0.875
Medal of Honor: Above and Beyond,27,15,6,48,0.875
Age of Empires IV,371,77,64,512,0.875
NCAA Football 11,40,9,7,56,0.875
Ghostbusters: Sanctum of Slime,10,39,7,56,0.875
Killzone Trilogy,31,4,5,40,0.875
NieR: Automata - 3C3C1D119440927,68,23,13,104,0.875
Ancient Space,37,12,7,56,0.875
Tales of Hearts R,97,15,16,128,0.875
Abo Khashem,41,22,9,72,0.875
God Eater 3,106,34,20,160,0.875
No More Heroes III,177,26,29,232,0.875
Monster Sanctuary,74,10,12,96,0.875
Yggdra Union: We'll Never Fight Alone,24,4,4,32,0.875
Crazy Frog Arcade Racer,22,13,5,40,0.875
Akiba's Beat,30,12,6,48,0.875
Airport Simulator 2014,4,24,4,32,0.875
Dishonored: The Brigmore Witches,324,12,48,384,0.875
Strike Suit Infinity,21,7,4,32,0.875
Super Hydorah,23,5,4,32,0.875
Dragon Ball Z: The Legacy of Goku II,40,2,6,48,0.875
Wipeout Fusion,26,2,4,32,0.875
Emperor: Battle for Dune,66,4,10,80,0.875
Frogger 2: Swampy's Revenge,26,2,4,32,0.875
Toy Soldiers: War Chest,96,30,18,144,0.875
Pistol Whip,85,20,15,120,0.875
The Gate of Firmament,21,7,4,32,0.875
Total War: WARHAMMER III,170,166,48,384,0.875
Disgaea 6: Defiance of Destiny,25,24,7,56,0.875
Mad Father Remake,24,4,4,32,0.875
Champions of Norrath,46,3,7,56,0.875
Deponia: The Complete Journey,35,7,6,48,0.875
Adventures of Mana,25,3,4,32,0.875
Assault Android Cactus,59,25,12,96,0.875
Total War: Attila - Age of Charlemagne,26,2,4,32,0.875
Growtopia,33,23,8,64,0.875
Escape Doodland,20,8,4,32,0.875
Super Mario Sunshine,844,57,129,1030,0.874757281553398
Rise of the Tomb Raider,3048,430,498,3976,0.8747484909456741
IL-2 Sturmovik: Battle of Stalingrad,147,97,35,279,0.8745519713261649
DiRT Rally,686,80,110,876,0.8744292237442922
Stray,2491,238,392,3121,0.8743992310157
World of Tanks,792,1561,338,2691,0.8743961352657005
Payday 2,1642,2493,595,4730,0.8742071881606766
BioShock 2: Minerva's Den,248,9,37,294,0.8741496598639455
Little Misfortune,95,16,16,127,0.8740157480314961
Robin Hood: The Legend of Sherwood,100,4,15,119,0.8739495798319328
Party Animals,90,14,15,119,0.8739495798319328
Dragon's Dogma,642,79,104,825,0.8739393939393939
Leisure Suit Larry: Reloaded,151,22,25,198,0.8737373737373737
Hitman - Intro Pack,215,290,73,578,0.8737024221453287
Tesla Effect: A Tex Murphy Adventure,142,17,23,182,0.8736263736263736
Monster Hunter Tri,141,18,23,182,0.8736263736263736
Hyperdimension Neptunia Victory,62,14,11,87,0.8735632183908046
Total War: WARHAMMER,598,148,108,854,0.8735362997658079
Knock-knock,185,29,31,245,0.8734693877551021
Like a Dragon: Ishin!,167,40,30,237,0.8734177215189873
Retro City Rampage DX,111,27,20,158,0.8734177215189873
Contra Anniversary Collection,46,23,10,79,0.8734177215189873
Dawn of Fantasy,45,17,9,71,0.8732394366197183
Monster Monpiece,48,14,9,71,0.8732394366197183
Fable: The Lost Chapters,634,27,96,757,0.8731836195508587
Shadowrun: Dragonfall,214,20,34,268,0.8731343283582089
Hyperdimension Neptunia PP: Producing Perfection,34,21,8,63,0.873015873015873
Bit.Trip Complete / THE BIT.TRIP,45,10,8,63,0.873015873015873
X-Men Legends II: Rise of Apocalypse,146,19,24,189,0.873015873015873
Putty Squad,16,39,8,63,0.873015873015873
Romance of the Three Kingdoms XI,46,9,8,63,0.873015873015873
Dark Devotion,41,14,8,63,0.873015873015873
Toukiden: Kiwami,130,28,23,181,0.8729281767955801
Dishonored,6467,430,1005,7902,0.8728170083523159
Slime-san,41,7,7,55,0.8727272727272727
Mario Party Superstars,241,33,40,314,0.8726114649681529
Crimson Dragon,147,79,33,259,0.8725868725868726
Tomb Raider,6582,422,1023,8027,0.8725551264482372
Teardown,75,14,13,102,0.8725490196078431
Puyo Puyo Tetris,221,32,37,290,0.8724137931034482
Guns of Icarus Online,245,49,43,337,0.8724035608308606
Yo-kai Watch 2: Psychic Specters,74,8,12,94,0.8723404255319149
Etherborn,32,9,6,47,0.8723404255319149
Car Mechanic Simulator,21,20,6,47,0.8723404255319149
Final Fantasy Crystal Chronicles: Remastered Edition,46,77,18,141,0.8723404255319149
Tales of Symphonia Chronicles,147,17,24,188,0.8723404255319149
Ikaruga,134,23,23,180,0.8722222222222222
Valiant Hearts: The Great War,1498,126,238,1862,0.8721804511278195
"Papers, Please",1501,61,229,1791,0.8721384701284198
Tom Clancy's Rainbow Six Extraction,190,226,61,477,0.8721174004192872
Pac-Man Championship Edition DX,188,37,33,258,0.872093023255814
The Missing: JJ Macfield and the Island of Memories,52,23,11,86,0.872093023255814
God of War: Chains of Olympus,937,65,147,1149,0.8720626631853786
Company of Heroes: Opposing Fronts,133,10,21,164,0.8719512195121951
Agony,163,300,68,531,0.871939736346516
Football Manager 2012,159,18,26,203,0.8719211822660099
Total War: Three Kingdoms,288,66,52,406,0.8719211822660099
Dungeon of the Endless,205,40,36,281,0.8718861209964412
Devil's Third,187,92,41,320,0.871875
Galactic Civilizations II: Ultimate Edition,31,3,5,39,0.8717948717948718
Chaos;Child,63,5,10,78,0.8717948717948718
Test Drive 5,32,2,5,39,0.8717948717948718
Mugen Souls,25,9,5,39,0.8717948717948718
Lula: The Sexy Empire,19,15,5,39,0.8717948717948718
Hitman - Episode 2: Sapienza,154,70,33,257,0.8715953307392996
Tenchu: Stealth Assassins,90,5,14,109,0.8715596330275229
Frostpunk,943,81,151,1175,0.8714893617021277
World of Warcraft: Warlords of Draenor,656,1242,280,2178,0.8714416896235078
FORCED,97,25,18,140,0.8714285714285714
Travis Strikes Again: No More Heroes,204,40,36,280,0.8714285714285714
Gears of War 2,1312,83,206,1601,0.8713304184884447
Fire Emblem Fates: Conquest,454,80,79,613,0.8711256117455138
Assassin's Creed Valhalla,6872,2155,1337,10364,0.8709957545349286
Sega 3D Classics Collection,23,4,4,31,0.8709677419354839
Lemnis Gate,14,13,4,31,0.8709677419354839
Sniper: Art of Victory,6,21,4,31,0.8709677419354839
Champions of Anteria,19,8,4,31,0.8709677419354839
Magicite,22,5,4,31,0.8709677419354839
Europa Universalis IV: Wealth of Nations,26,1,4,31,0.8709677419354839
Krinkle Krusher,39,15,8,62,0.8709677419354839
Drakan: The Ancients' Gates,24,3,4,31,0.8709677419354839
The LEGO Movie 2 Videogame,20,34,8,62,0.8709677419354839
Sid Meier's Civilization III: Complete,26,1,4,31,0.8709677419354839
Puzzle Pirates,18,9,4,31,0.8709677419354839
Tiny Metal,25,29,8,62,0.8709677419354839
Rock of Ages 2: Bigger & Boulder,42,12,8,62,0.8709677419354839
Kill Strain,20,7,4,31,0.8709677419354839
State of Decay 2: Heartland,17,10,4,31,0.8709677419354839
God of War III Remastered,1323,94,210,1627,0.8709280885064536
Borderlands: The Handsome Collection,684,91,115,890,0.8707865168539326
Tokyo Mirage Sessions #FE Encore,148,81,34,263,0.870722433460076
Shadowrun: Dragonfall - Director's Cut,274,29,45,348,0.8706896551724138
Ape Escape,95,6,15,116,0.8706896551724138
Command & Conquer: Tiberian Sun,100,1,15,116,0.8706896551724138
Resident Evil: Revelations 2 - Episode 1: Penal Colony,269,81,52,402,0.8706467661691543
Hellblade: Senua's Sacrifice,2955,437,504,3896,0.8706365503080082
Legends of Eisenwald,60,14,11,85,0.8705882352941177
The Stanley Parable: Ultra Deluxe,333,37,55,425,0.8705882352941177
Prime World: Defenders,97,24,18,139,0.8705035971223022
Battlefield 2,735,31,114,880,0.8704545454545455
Catherine,666,86,112,864,0.8703703703703703
Star Wars Battlefront: Outer Rim,23,24,7,54,0.8703703703703703
iRacing,63,31,14,108,0.8703703703703703
JoJo's Bizarre Adventure HD Ver.,26,21,7,54,0.8703703703703703
AeternoBlade II,23,24,7,54,0.8703703703703703
Asterix & Obelix: Slap Them All!,24,23,7,54,0.8703703703703703
Gran Turismo Sport,1010,668,250,1928,0.8703319502074689
Naruto Shippuden: Ultimate Ninja Storm 3 Full Burst,298,44,51,393,0.8702290076335878
Quake Remastered,95,19,17,131,0.8702290076335878
Beyond Blue,95,19,17,131,0.8702290076335878
FlatOut 2,396,13,61,470,0.8702127659574468
World of Warcraft Classic,152,96,37,285,0.8701754385964913
Tony Hawk's Pro Skater 2,1053,227,191,1471,0.8701563562202583
Fairy Fencer F,40,27,10,77,0.8701298701298701
Pyre,302,46,52,400,0.87
Hatsune Miku: Project Diva f,165,29,29,223,0.8699551569506726
Slay the Spire,746,136,132,1014,0.8698224852071006
Professor Layton and the Miracle Mask,135,12,22,169,0.8698224852071006
Shadow of the Beast,115,32,22,169,0.8698224852071006
Divine Divinity,174,13,28,215,0.8697674418604651
Supreme Commander,191,16,31,238,0.8697478991596639
Impossible Creatures,35,5,6,46,0.8695652173913043
Contradiction - Spot The Liar!,35,5,6,46,0.8695652173913043
Planet Zoo,124,16,21,161,0.8695652173913043
King's Bounty: Armored Princess,212,8,33,253,0.8695652173913043
You Don't Know Jack (2011),44,16,9,69,0.8695652173913043
Mutazione,48,12,9,69,0.8695652173913043
The Witch's House MV,36,4,6,46,0.8695652173913043
Littlewood,36,4,6,46,0.8695652173913043
Guilty Gear XX Accent Core Plus R,31,9,6,46,0.8695652173913043
Counter-Strike Nexon: Zombies,15,25,6,46,0.8695652173913043
Shadow of the Tomb Raider: Definitive Edition,65,15,12,92,0.8695652173913043
Sid Meier's Civilization IV,770,43,122,935,0.8695187165775401
Gravity Rush 2,521,85,91,697,0.8694404591104734
The Elder Scrolls Online: Morrowind,145,68,32,245,0.8693877551020408
Dead Cells,1418,139,234,1791,0.8693467336683417
Gears of War: Ultimate Edition,695,202,135,1032,0.8691860465116279
The Binding of Isaac: The Wrath of the Lamb,84,9,14,107,0.8691588785046729
Knights and Bikes,58,35,14,107,0.8691588785046729
Dance Central (2010),65,8,11,84,0.8690476190476191
Pokemon Mystery Dungeon: Rescue Team DX,253,39,44,336,0.8690476190476191
Life is Strange 2: Episode 3 - Wastelands,71,55,19,145,0.8689655172413793
Battleborn,630,252,133,1015,0.8689655172413793
SimCity 4,284,7,44,335,0.8686567164179104
Geometry Wars 3: Dimensions,141,44,28,213,0.8685446009389671
Destiny: The Taken King,866,600,222,1688,0.8684834123222749
Monster Jam Steel Titans,12,21,5,38,0.868421052631579
Octahedron,26,7,5,38,0.868421052631579
Weedcraft Inc,23,10,5,38,0.868421052631579
Kayak VR: Mirage,18,15,5,38,0.868421052631579
Unbound: Worlds Apart,26,7,5,38,0.868421052631579
DJ Hero 2,58,8,10,76,0.868421052631579
Dino Crisis 3,7,26,5,38,0.868421052631579
Lost Eidolons,27,6,5,38,0.868421052631579
Mario & Luigi: Partners in Time,190,8,30,228,0.868421052631579
Scooby-Doo! Unmasked,28,5,5,38,0.868421052631579
Minecraft: Story Mode Season Two - Episode 4: Below the Bedrock,27,6,5,38,0.868421052631579
Ibb & Obb,57,9,10,76,0.868421052631579
Snack World: The Dungeon Crawl Gold,51,15,10,76,0.868421052631579
Bayonetta 3,452,154,92,698,0.8681948424068768
MotorStorm: Arctic Edge,62,17,12,91,0.8681318681318682
Bomb Rush Cyberfunk,73,6,12,91,0.8681318681318682
MDK2,78,14,14,106,0.8679245283018868
Tzar: The Burden of the Crown,42,4,7,53,0.8679245283018868
Taiko no Tatsujin: Drum 'n' Fun!,42,4,7,53,0.8679245283018868
Kentucky Route Zero - Act II,37,9,7,53,0.8679245283018868
MDK,43,3,7,53,0.8679245283018868
Pokemon Mystery Dungeon: Explorers of Darkness,87,5,14,106,0.8679245283018868
Marvel Heroes,409,202,93,704,0.8678977272727273
The Dark Pictures Anthology: House of Ashes,542,75,94,711,0.8677918424753868
Tom Clancy's Splinter Cell,582,35,94,711,0.8677918424753868
Funk of Titans,14,45,9,68,0.8676470588235294
Rune Factory: Tides of Destiny,47,12,9,68,0.8676470588235294
Star Wars Jedi: Survivor,1136,828,300,2264,0.8674911660777385
Kero Blaster,53,19,11,83,0.8674698795180723
Omikron: The Nomad Soul,60,12,11,83,0.8674698795180723
NHL 24,17,55,11,83,0.8674698795180723
Crash Bandicoot 4: It's About Time,1080,196,195,1471,0.86743711760707
Crime Boss: Rockay City,39,46,13,98,0.8673469387755102
Bloodstained: Curse of the Moon,322,44,56,422,0.8672985781990521
SpellForce: The Order of Dawn,90,8,15,113,0.8672566371681416
NHL 11,89,22,17,128,0.8671875
Trials Rising,129,86,33,248,0.8669354838709677
Forza Motorsport,675,263,144,1082,0.866913123844732
Broken Age: Act 1,263,56,49,368,0.8668478260869565
Legend of Grimrock II,286,46,51,383,0.8668407310704961
The Messenger,437,51,75,563,0.866785079928952
Rocket League,3409,460,595,4464,0.8667114695340502
Dr. Seuss' Green Eggs and Ham,19,7,4,30,0.8666666666666667
Samurai Warriors: Spirit of Sanada,20,6,4,30,0.8666666666666667
Dreamfall Chapters Book One: Reborn,39,13,8,60,0.8666666666666667
MX vs. ATV Supercross Encore,9,17,4,30,0.8666666666666667
Cyber Protocol,20,6,4,30,0.8666666666666667
Valfaris,121,22,22,165,0.8666666666666667
Harvest Moon: A Wonderful Life,51,14,10,75,0.8666666666666667
Soldier of Fortune: Payback,50,15,10,75,0.8666666666666667
Flinthook,46,19,10,75,0.8666666666666667
One Finger Death Punch,112,5,18,135,0.8666666666666667
Tom Clancy's The Division - Survival,18,8,4,30,0.8666666666666667
TIS-100,22,4,4,30,0.8666666666666667
Yo-kai Watch 2: Bony Spirits,56,9,10,75,0.8666666666666667
Total War: Rome II - Emperor Edition,121,35,24,180,0.8666666666666667
Devilian,16,10,4,30,0.8666666666666667
Knights and Merchants: The Shattered Kingdom,48,4,8,60,0.8666666666666667
New Gundam Breaker,10,42,8,60,0.8666666666666667
Eastshade,54,11,10,75,0.8666666666666667
Supersonic Acrobatic Rocket-Powered Battle-Cars,39,13,8,60,0.8666666666666667
F-Zero: GP Legend,25,1,4,30,0.8666666666666667
The Golden Compass,14,25,6,45,0.8666666666666667
Deus Ex: Mankind Divided - System Rift,54,11,10,75,0.8666666666666667
Journey Collector's Edition,60,5,10,75,0.8666666666666667
Tomb Raider: Definitive Edition,2163,203,364,2730,0.8666666666666667
Pikmin,253,7,40,300,0.8666666666666667
Guacamelee! 2,234,39,42,315,0.8666666666666667
The Legend of Bum-bo,73,5,12,90,0.8666666666666667
Endling - Extinction is Forever,106,11,18,135,0.8666666666666667
The Medium,1542,485,312,2339,0.8666096622488243
DmC: Devil May Cry,3022,1721,731,5474,0.8664596273291926
Psychonauts,731,66,123,920,0.866304347826087
High on Life,1069,213,198,1480,0.8662162162162163
Injustice 2,1105,177,198,1480,0.8662162162162163
Sword Art Online: Hollow Realization,94,29,19,142,0.8661971830985915
Pokemon White Version 2,352,62,64,478,0.8661087866108786
Nights of Azure,73,24,15,112,0.8660714285714286
Hitman HD Trilogy,79,18,15,112,0.8660714285714286
The Binding of Isaac,905,77,152,1134,0.8659611992945326
Final Fantasy VIII Remastered,233,90,50,373,0.8659517426273459
Ys IX: Monstrum Nox,136,19,24,179,0.8659217877094972
Mark of the Ninja,1073,141,188,1402,0.8659058487874465
MediEvil,504,77,90,671,0.8658718330849479
The Walking Dead: The Telltale Series - The Final Season,561,78,99,738,0.8658536585365854
Death Mark,62,9,11,82,0.8658536585365854
Super Street Fighter II Turbo HD Remix,57,14,11,82,0.8658536585365854
DOLMEN,41,30,11,82,0.8658536585365854
Soul Sacrifice,238,33,42,313,0.865814696485623
Samorost 3,111,18,20,149,0.8657718120805369
Naruto Shippuden: Ultimate Ninja Storm 4,651,71,112,834,0.8657074340527577
"Bury me, my Love",20,38,9,67,0.8656716417910447
Monster Hunter: World,2343,633,462,3438,0.8656195462478184
Ratchet & Clank (PS4),2350,153,389,2892,0.8654910096818811
AVICII Invector,36,9,7,52,0.8653846153846154
Infernax,69,21,14,104,0.8653846153846154
Praey for the Gods,27,18,7,52,0.8653846153846154
War Inc. Battle Zone,17,28,7,52,0.8653846153846154
Matterfall,37,8,7,52,0.8653846153846154
Looney Tunes: Sheep Raider,42,3,7,52,0.8653846153846154
Heavy Rain,3140,302,536,3978,0.8652589240824535
"Warhammer 40,000: Mechanicus",103,19,19,141,0.8652482269503546
Marvel's Midnight Suns,244,83,51,378,0.8650793650793651
Atelier Escha & Logy: Alchemists of the Dusk Sky,94,15,17,126,0.8650793650793651
World of Warcraft: Mists of Pandaria,857,648,235,1740,0.8649425287356322
Beacon Pines,52,12,10,74,0.8648648648648649
WildStar,657,175,130,962,0.8648648648648649
Oddworld: Soulstorm Enhanced Edition,22,10,5,37,0.8648648648648649
Lost in Random,168,43,33,244,0.8647540983606558
Everybody's Golf,119,28,23,170,0.8647058823529412
Hunt: Showdown,470,156,98,724,0.8646408839779005
Spiritfarer,356,40,62,458,0.8646288209606987
Farming Simulator 22,52,31,13,96,0.8645833333333334
Sonic & Knuckles,49,2,8,59,0.864406779661017
World of Warplanes,133,141,43,317,0.8643533123028391
DayZ,127,255,60,442,0.8642533936651584
Kinectimals,24,46,11,81,0.8641975308641975
Mutant Mudds Deluxe,48,22,11,81,0.8641975308641975
SpongeBob SquarePants: Battle for Bikini Bottom,271,28,47,346,0.8641618497109826
Starcraft II: Heart of the Swarm,1258,178,226,1662,0.8640192539109507
Before Your Eyes,92,16,17,125,0.864
Final Fantasy XII: Revenant Wings,139,7,23,169,0.863905325443787
Fallout 4: Wasteland Workshop,33,170,32,235,0.8638297872340426
Minecraft,8517,1417,1566,11500,0.8638260869565217
Redout (2016),181,41,35,257,0.8638132295719845
Super Mario 3D Land,1222,64,203,1489,0.8636668905305575
POSTAL: Brain Damaged,35,3,6,44,0.8636363636363636
People Playground,74,2,12,88,0.8636363636363636
Rock Band Blitz,28,10,6,44,0.8636363636363636
Mass Effect 3: Earth,25,13,6,44,0.8636363636363636
War of the Vikings,36,21,9,66,0.8636363636363636
Neverwinter Nights: Enhanced Edition,37,39,12,88,0.8636363636363636
Fuser,29,9,6,44,0.8636363636363636
Pursuit Force: Extreme Justice,35,3,6,44,0.8636363636363636
Gemini Rue: Verschworung auf Barracus,195,14,33,242,0.8636363636363636
Neverwinter Nights: Hordes of the Underdark,106,8,18,132,0.8636363636363636
Destruction AllStars,241,291,84,616,0.8636363636363636
Metal Gear Solid V: The Phantom Pain,8459,1367,1554,11380,0.8634446397188049
Sword Art Online: Hollow Fragment,95,25,19,139,0.8633093525179856
Pillars of Eternity II: Deadfire,613,170,124,907,0.8632855567805954
The Jackbox Party Pack,80,21,16,117,0.8632478632478633
Age of Empires III: The Asian Dynasties,79,3,13,95,0.8631578947368421
Final Fantasy Crystal Chronicles,158,6,26,190,0.8631578947368421
Inmost,73,9,13,95,0.8631578947368421
Pokemon Mystery Dungeon: Explorers of Time,135,10,23,168,0.8630952380952381
Carmageddon: Reincarnation,57,88,23,168,0.8630952380952381
Metal Wolf Chaos XD,38,25,10,73,0.863013698630137
Dragon Ball: Fusions,56,7,10,73,0.863013698630137
Stellaris,812,126,149,1087,0.8629254829806807
Metal Gear Rising: Revengeance,2085,212,365,2662,0.862885048835462
Yoku's Island Express,216,23,38,277,0.8628158844765343
Pokemon Moon,704,170,139,1013,0.8627838104639685
Age of Empires: The Age of Kings,43,1,7,51,0.8627450980392157
GT Legends,34,10,7,51,0.8627450980392157
DOOM VFR,138,38,28,204,0.8627450980392157
Guild Wars,243,27,43,313,0.8626198083067093
King's Bounty: Crossworlds,107,6,18,131,0.8625954198473282
GRIS,956,86,166,1208,0.8625827814569537
Borderlands 2,4938,532,872,6342,0.8625039419741406
Persona 5 Tactica,122,16,22,160,0.8625
AI War: Fleet Command,55,14,11,80,0.8625
Kingdom Hearts III + Re Mind,46,23,11,80,0.8625
Ys Origin,206,26,37,269,0.862453531598513
Serious Sam HD: The Second Encounter,183,17,32,232,0.8620689655172413
Praetorians,44,6,8,58,0.8620689655172413
Spellbreak,195,30,36,261,0.8620689655172413
"Mafia III: Faster, Baby!",76,24,16,116,0.8620689655172413
Outer Wilds: Echoes of the Eye,70,5,12,87,0.8620689655172413
Final Fantasy,198,33,37,268,0.8619402985074627
Endless Legend,418,62,77,557,0.8617594254937163
Need for Speed: Underground,722,38,122,882,0.8616780045351474
Dishonored: The Knife of Dunwall,390,21,66,477,0.8616352201257862
Frozen Synapse Prime,35,21,9,65,0.8615384615384616
DOOM Eternal: The Ancient Gods Part Two,105,38,23,166,0.8614457831325302
Star Fox Zero,523,142,107,772,0.8613989637305699
NBA 07,72,46,19,137,0.8613138686131386
Golf Story,274,24,48,346,0.861271676300578
Fantasy Life,223,19,39,281,0.8612099644128114
Crimson Skies: High Road to Revenge,30,1,5,36,0.8611111111111112
Tactics Ogre: The Knight of Lodis,29,2,5,36,0.8611111111111112
Europa Universalis,25,6,5,36,0.8611111111111112
Millennium: A New Hope,32,30,10,72,0.8611111111111112
Riviera: The Promised Land,27,4,5,36,0.8611111111111112
Diggles,28,3,5,36,0.8611111111111112
America's Army: Proving Grounds,20,11,5,36,0.8611111111111112
PixelJunk Monsters 2,49,13,10,72,0.8611111111111112
MotoGP 19,50,12,10,72,0.8611111111111112
Animal Crossing: New Horizons - Happy Home Paradise,28,3,5,36,0.8611111111111112
Sam & Max: The Devil's Playhouse - Episode 2: The Tomb of Sammun-Mak,26,5,5,36,0.8611111111111112
Deus Ex: Mankind Divided - A Criminal Past,80,13,15,108,0.8611111111111112
Alwa's Awakening,22,9,5,36,0.8611111111111112
NCAA Football 2004,17,14,5,36,0.8611111111111112
Arise: A Simple Story,156,36,31,223,0.8609865470852018
The Stanley Parable,1789,236,327,2352,0.860969387755102
"Harry Potter and the Deathly Hallows, Part 1",43,118,26,187,0.8609625668449198
Fran Bow,147,14,26,187,0.8609625668449198
Machinarium,703,40,120,863,0.8609501738122828
Town of Salem,85,14,16,115,0.8608695652173913
Spider-Man (2000),349,22,60,431,0.8607888631090487
Tron 2.0,63,5,11,79,0.8607594936708861
Oxygen Not Included,124,12,22,158,0.8607594936708861
Grim Dawn,661,56,116,833,0.8607442977190877
Teenage Mutant Ninja Turtles: Shredder's Revenge,476,43,84,603,0.8606965174129353
Good Job!,33,4,6,43,0.8604651162790697
Senran Kagura: Bon Appetit!,28,9,6,43,0.8604651162790697
Hotline Miami Collection,33,4,6,43,0.8604651162790697
Diablo Hellfire Bundle,36,1,6,43,0.8604651162790697
Jet Force Gemini,71,3,12,86,0.8604651162790697
Heroes of Annihilated Empires,31,6,6,43,0.8604651162790697
Men of War: Red Tide,32,5,6,43,0.8604651162790697
The Legend of Zelda: Skyward Sword,2028,289,376,2693,0.8603787597474934
Duke Nukem 3D,483,22,82,587,0.8603066439522998
Roki,70,10,13,93,0.8602150537634409
Kena: Bridge of Spirits,1664,175,299,2138,0.8601496725912068
Paradigm,37,6,7,50,0.86
Phantom Doctrine,130,42,28,200,0.86
Ben 10,18,25,7,50,0.86
STAY (2018),30,13,7,50,0.86
Hello Neighbor: Hide & Seek,22,21,7,50,0.86
Wattam,27,16,7,50,0.86
"Warhammer 40,000: Dawn of War III",164,266,70,500,0.86
Need for Speed III: Hot Pursuit,83,3,14,100,0.86
Dysmantle,36,7,7,50,0.86
What Remains of Edith Finch,1836,154,324,2314,0.8599827139152982
Icewind Dale: Enhanced Edition,108,27,22,157,0.8598726114649682
Uncharted: The Lost Legacy,1960,199,352,2511,0.8598168060533652
BOXBOY!,45,4,8,57,0.8596491228070176
Skate,92,6,16,114,0.8596491228070176
Castle Crashers Remastered,87,11,16,114,0.8596491228070176
Path of Exile: The Fall of Oriath,36,13,8,57,0.8596491228070176
DmC: Devil May Cry Definitive Edition,752,166,150,1068,0.8595505617977528
Diablo III: Rise of the Necromancer,82,126,34,242,0.859504132231405
Life is Strange: Before the Storm - Episode 3: Hell is Empty,116,43,26,185,0.8594594594594595
Dreamfall Chapters,296,83,62,441,0.8594104308390023
Hearthstone: Heroes of Warcraft - Knights of the Frozen Throne,13,42,9,64,0.859375
Dragon Ball: The Breakers,19,36,9,64,0.859375
Sengoku Basara: Samurai Heroes,50,5,9,64,0.859375
Pool Nation,98,12,18,128,0.859375
Halo Wars: Definitive Edition,141,24,27,192,0.859375
Pandora's Tower,101,9,18,128,0.859375
Geometry Wars: Retro Evolved 2,52,3,9,64,0.859375
Thimbleweed Park,342,49,64,455,0.8593406593406593
Samurai Warriors 4,97,19,19,135,0.8592592592592593
Dragon Ball FighterZ,944,161,181,1286,0.859253499222395
EverQuest,50,11,10,71,0.8591549295774648
Alba: a Wildlife Adventure,55,6,10,71,0.8591549295774648
Life is Strange 2: Episode 5 - Wolves,79,49,21,149,0.8590604026845637
Monster Boy and the Cursed Kingdom,231,37,44,312,0.8589743589743589
Pokemon Sword / Shield: The Crown Tundra,151,50,33,234,0.8589743589743589
Silent Hunter III,59,8,11,78,0.8589743589743589
X-Morph: Defense,55,12,11,78,0.8589743589743589
Deep Rock Galactic,439,48,80,567,0.8589065255731922
DOOM Eternal: The Ancient Gods Part One,173,40,35,248,0.8588709677419355
Hypnospace Outlaw,50,23,12,85,0.8588235294117647
Mario Kart Live: Home Circuit,53,20,12,85,0.8588235294117647
Shredders,43,30,12,85,0.8588235294117647
Tom Clancy's Ghost Recon: Shadow Wars,66,7,12,85,0.8588235294117647
Sonic Adventure 2,1005,95,181,1281,0.8587041373926619
Aliens: Dark Descent,134,24,26,184,0.8586956521739131
Dragon Ball Z: Kakarot,1002,146,189,1337,0.8586387434554974
Quake Live,75,10,14,99,0.8585858585858586
Assassin's Creed IV: Black Flag,6929,745,1264,8938,0.858581338106959
NBA 2K Playgrounds 2,52,45,16,113,0.8584070796460177
Hyrule Warriors: Age of Calamity,504,78,96,678,0.8584070796460177
Gears Tactics,498,102,99,699,0.8583690987124464
Corpse Party: Blood Drive,90,13,17,120,0.8583333333333333
Borderlands: Game of the Year Edition,285,48,55,388,0.8582474226804123
Outriders,850,560,233,1643,0.8581862446743761
The Warriors,127,12,23,162,0.8580246913580247
Age of Empires III: Definitive Edition,120,37,26,183,0.8579234972677595
Haven,165,46,35,246,0.8577235772357723
Yakuza 4,222,25,41,288,0.8576388888888888
Daemon X Machina,237,58,49,344,0.8575581395348837
Fire Emblem Fates: Special Edition,278,59,56,393,0.8575063613231552
Wolfenstein: The New Order,4306,410,784,5500,0.8574545454545455
N+,85,5,15,105,0.8571428571428571
"Warhammer 40,000: Dawn of War II - Chaos Rising",150,12,27,189,0.8571428571428571
Dangerous Golf,22,44,11,77,0.8571428571428571
The Tomorrow Children,42,36,13,91,0.8571428571428571
Jazz Jackrabbit 2,47,1,8,56,0.8571428571428571
Samurai Warriors 5,83,13,16,112,0.8571428571428571
Rise of Immortals: Battle for Graxia,15,15,5,35,0.8571428571428571
Ragnarok Online 2: Legend of the Second,12,42,9,63,0.8571428571428571
Etherlords II,55,5,10,70,0.8571428571428571
Army Men: RTS,35,7,7,49,0.8571428571428571
Pathfinder: Kingmaker,406,116,87,609,0.8571428571428571
Sprint Vector,31,11,7,49,0.8571428571428571
DNF Duel: Who's Next,13,17,5,35,0.8571428571428571
IL-2 Sturmovik: Cliffs of Dover,71,31,17,119,0.8571428571428571
Total War: Rome II - Caesar in Gaul,18,30,8,56,0.8571428571428571
Guitar Hero III: Legends of Rock,306,24,55,385,0.8571428571428571
Guild Wars: Eye of the North,56,4,10,70,0.8571428571428571
Tokyo Twilight Ghost Hunters,22,8,5,35,0.8571428571428571
Ashes of the Singularity,52,26,13,91,0.8571428571428571
Mega Man Battle Network 2,27,9,6,42,0.8571428571428571
Relicta,33,21,9,63,0.8571428571428571
DOFUS,36,12,8,56,0.8571428571428571
Mega Man ZX,56,4,10,70,0.8571428571428571
Ace Combat X: Skies of Deception,27,3,5,35,0.8571428571428571
MotoGP 10/11,31,11,7,49,0.8571428571428571
Onimusha 3: Demon Siege,133,5,23,161,0.8571428571428571
Kingdom Hearts HD 2.8 Final Chapter Prologue,365,49,69,483,0.8571428571428571
Sunset Overdrive and the Mystery of the Mooil Rig!,23,7,5,35,0.8571428571428571
SteamWorld Heist,383,55,73,511,0.8571428571428571
Geometry Wars 3: Dimensions Evolved,23,7,5,35,0.8571428571428571
This War of Mine: Complete Edition,42,6,8,56,0.8571428571428571
Yu-Gi-Oh! Legacy of the Duelist: Link Evolution,82,26,18,126,0.8571428571428571
The Matrix Awakens: An Unreal Engine 5 Experience,46,2,8,56,0.8571428571428571
Friday Night Funkin',27,9,6,42,0.8571428571428571
Borderlands 3,2526,1884,737,5147,0.8568097921119099
Bit.Trip Presents...Runner2: Future Legend of Rhythm Alien,271,40,52,363,0.8567493112947658
Pro Evolution Soccer 2019,305,173,80,558,0.8566308243727598
No More Heroes,213,14,38,265,0.8566037735849057
Guardians of Middle-Earth,148,61,35,244,0.8565573770491803
Need for Speed Unbound,535,450,165,1150,0.8565217391304348
Red Dead Redemption: Undead Nightmare Pack,513,42,93,648,0.8564814814814815
ToeJam & Earl: Back in the Groove!,99,62,27,188,0.8563829787234043
Quake,836,28,145,1009,0.8562933597621407
Hyper Light Drifter,500,72,96,668,0.8562874251497006
Final Fantasy XV,4646,968,943,6557,0.8561842305932591
Transistor,1372,127,252,1751,0.856082238720731
Monochroma,74,33,18,125,0.856
Fable (2004),203,11,36,250,0.856
Spirit of the North,77,24,17,118,0.8559322033898306
SIFU,768,135,152,1055,0.8559241706161137
Albion Online,99,97,33,229,0.8558951965065502
Earth Defense Force 4.1: The Shadow of New Despair,77,18,16,111,0.8558558558558559
The Forgotten City,341,39,64,444,0.8558558558558559
Age of Empires,344,30,63,437,0.8558352402745996
SMITE,885,189,181,1255,0.8557768924302789
Street Fighter III: 3rd Strike - Fight for the Future,147,31,30,208,0.8557692307692307
Life is Strange 2: Episode 4 - Faith,39,50,15,104,0.8557692307692307
Jak II,394,39,73,506,0.8557312252964426
The Tomb Raider Trilogy,68,9,13,90,0.8555555555555555
Dirty Bomb,185,40,38,263,0.8555133079847909
Star Trek: Voyager Elite Force,64,7,12,83,0.8554216867469879
Watch Dogs: Legion - Bloodline,53,12,11,76,0.8552631578947368
Assassin's Creed Origins: The Curse of the Pharaohs,202,52,43,297,0.8552188552188552
Dark Souls II: Crown of the Sunken King,248,53,51,352,0.8551136363636364
Sleeping Dogs,2279,217,423,2919,0.8550873586844809
World Series of Poker: Tournament of Champions,36,23,10,69,0.855072463768116
Minecraft: Story Mode - Episode 5: Order Up!,44,15,10,69,0.855072463768116
Need for Speed: High Stakes,113,5,20,138,0.855072463768116
Theatrhythm Final Fantasy,97,15,19,131,0.8549618320610687
Mega Man X Legacy Collection 2,24,29,9,62,0.8548387096774194
Company of Heroes 3,41,65,18,124,0.8548387096774194
Tatsunoko vs. Capcom: Ultimate All-Stars,48,5,9,62,0.8548387096774194
Paragon,105,54,27,186,0.8548387096774194
Advance Wars 1 + 2: Re-Boot Camp,92,14,18,124,0.8548387096774194
Metal Slug Anthology,90,10,17,117,0.8547008547008547
Miasmata,81,19,17,117,0.8547008547008547
Atelier Sophie: The Alchemist of the Mysterious Book,86,14,17,117,0.8547008547008547
Narita Boy,111,36,25,172,0.8546511627906976
Rodea the Sky Soldier,103,44,25,172,0.8546511627906976
Sonic CD,311,30,58,399,0.8546365914786967
Gunman Clive 2,40,7,8,55,0.8545454545454545
Saints Row: The Third - The Full Package,28,19,8,55,0.8545454545454545
Darkest Dungeon,1027,141,199,1367,0.8544257498171178
BattleTech,243,97,58,398,0.8542713567839196
NASCAR The Game: Inside Line,15,26,7,48,0.8541666666666666
Lost Reavers,29,12,7,48,0.8541666666666666
Braid,1089,87,201,1377,0.8540305010893247
Battlefield 3,7025,1392,1439,9856,0.853997564935065
Luigi's Mansion,368,18,66,452,0.8539823008849557
Red Steel 2,67,9,13,89,0.8539325842696629
Mega Man Zero,70,6,13,89,0.8539325842696629
The Void,67,9,13,89,0.8539325842696629
7 Days to Die,613,223,143,979,0.8539325842696629
Hand of Fate 2,128,24,26,178,0.8539325842696629
Battlefield 3: Aftermath,95,16,19,130,0.8538461538461538
MLB 15: The Show,152,29,31,212,0.8537735849056604
Call of Duty: Infinite Warfare - Sabotage,2,33,6,41,0.8536585365853658
Resident Evil: Revelations 2 - Episode 4: Metamorphosis,79,26,18,123,0.8536585365853658
The Golf Club 2019 featuring PGA Tour,39,31,12,82,0.8536585365853658
Duke Nukem Forever: The Doctor Who Cloned Me,53,17,12,82,0.8536585365853658
Gunpoint,329,21,60,410,0.8536585365853658
Resident Evil 7: biohazard - Banned Footage Vol. 1,48,22,12,82,0.8536585365853658
Samurai Warriors Chronicles,30,5,6,41,0.8536585365853658
Towns,33,72,18,123,0.8536585365853658
Football Manager 2021,68,31,17,116,0.853448275862069
Tales From The Borderlands: Episode 4 - Escape Plan Bravo,167,31,34,232,0.853448275862069
Blasphemous,703,153,147,1003,0.8534396809571286
Castlevania: Lords of Shadow,689,85,133,907,0.8533627342888643
Nights of Azure 2: Bride of the New Moon,48,16,11,75,0.8533333333333334
Disney Classic Games: Aladdin and the Lion King,36,28,11,75,0.8533333333333334
TT Isle of Man: Ride On The Edge,35,29,11,75,0.8533333333333334
YIIK: A Postmodern RPG,37,56,16,109,0.8532110091743119
The Cosmic Wheel Sisterhood,19,10,5,34,0.8529411764705882
Ys Book I & II,111,34,25,170,0.8529411764705882
Under Siege (2011),21,8,5,34,0.8529411764705882
Wulverblade,44,14,10,68,0.8529411764705882
Hot Wheels Unleashed 2: Turbocharged,25,4,5,34,0.8529411764705882
Borderlands 2: Headhunter Pack 2 - The Horrible Hunger of the Ravenous Wattle Gobbler,9,20,5,34,0.8529411764705882
Heart&Slash,23,6,5,34,0.8529411764705882
The Sims 4: Discover University,13,16,5,34,0.8529411764705882
Dead Space Ignition,17,41,10,68,0.8529411764705882
Star Wars: The Old Republic - Knights of the Fallen Empire,47,11,10,68,0.8529411764705882
Destiny 2: Black Armory,7,22,5,34,0.8529411764705882
Cuisine Royale,21,8,5,34,0.8529411764705882
Project Hospital,26,3,5,34,0.8529411764705882
WWE 2K22,232,98,57,387,0.8527131782945736
Sherlock Holmes: Chapter One,140,51,33,224,0.8526785714285714
Red Dead Online,74,169,42,285,0.8526315789473684
The Black Mirror,76,5,14,95,0.8526315789473684
No Straight Roads,142,72,37,251,0.852589641434263
AeternoBlade,27,25,9,61,0.8524590163934426
Urban Reign,49,3,9,61,0.8524590163934426
Red Matter 2,47,5,9,61,0.8524590163934426
Battlefleet Gothic: Armada 2,41,11,9,61,0.8524590163934426
Call of Duty: Infinite Warfare,1145,1753,502,3400,0.8523529411764705
Dark Souls II,4255,978,907,6140,0.8522801302931596
Affordable Space Adventures,66,9,13,88,0.8522727272727273
Pro Evolution Soccer 2018,428,120,95,643,0.8522550544323484
Kingdom Hearts 3D: Dream Drop Distance,424,49,82,555,0.8522522522522522
Heroes of Might & Magic III - HD Edition,122,126,43,291,0.852233676975945
RollerCoaster Tycoon 3,161,150,54,365,0.852054794520548
Diablo III: Ultimate Evil Edition,1602,287,328,2217,0.8520523229589535
Chivalry 2,192,159,61,412,0.8519417475728155
Disney Pirates of the Caribbean: At World's End,87,51,24,162,0.8518518518518519
Technobabylon,58,11,12,81,0.8518518518518519
Zanki Zero: Last Beginning,28,18,8,54,0.8518518518518519
The Golf Club 2,27,19,8,54,0.8518518518518519
"Warhammer 40,000: Boltgun",76,16,16,108,0.8518518518518519
Fallen Enchantress: Legendary Heroes,119,19,24,162,0.8518518518518519
Blade (2000),38,8,8,54,0.8518518518518519
N.E.R.O.: Nothing Ever Remains Obscure,50,19,12,81,0.8518518518518519
Going Under,37,9,8,54,0.8518518518518519
Tomb Raider (1996),332,30,63,425,0.851764705882353
Blues and Bullets - Episode 1: The End of Peace,67,42,19,128,0.8515625
Vampire: The Masquerade - Coteries of New York,85,24,19,128,0.8515625
Motorsport Manager,95,14,19,128,0.8515625
Pixel Piracy,51,35,15,101,0.8514851485148515
2Dark,42,21,11,74,0.8513513513513513
MotoGP 20,49,14,11,74,0.8513513513513513
TrackMania 2 Stadium,52,11,11,74,0.8513513513513513
The Witcher: Enhanced Edition,2562,210,484,3256,0.8513513513513513
LEGO City Undercover,532,69,105,706,0.8512747875354107
Call of Duty 2,1152,32,207,1391,0.8511861969805895
Battletoads,497,298,139,934,0.8511777301927195
Dragon Ball Z: Buu's Fury,36,4,7,47,0.851063829787234
Trillion: God of Destruction,31,9,7,47,0.851063829787234
Night in the Woods,570,144,125,839,0.8510131108462455
SoulCalibur VI,354,240,104,698,0.8510028653295129
Torchlight II,1759,137,332,2228,0.8509874326750448
Mario Kart 64,419,15,76,510,0.8509803921568627
Far Cry 3: Blood Dragon,1404,120,267,1791,0.8509212730318257
Hood: Outlaws & Legends,43,54,17,114,0.8508771929824561
Batman: Arkham City - Catwoman Bundle Pack,51,6,10,67,0.8507462686567164
SimCity 3000 Unlimited,54,3,10,67,0.8507462686567164
Age of Mythology: Extended Edition,142,29,30,201,0.8507462686567164
IRONFALL Invasion,32,25,10,67,0.8507462686567164
The Life and Suffering of Sir Brante,105,9,20,134,0.8507462686567164
The Elder Scrolls Online: Summerset,104,67,30,201,0.8507462686567164
Pokemon Sword,2031,3081,897,6009,0.8507239141288068
ReCore,468,244,125,837,0.8506571087216248
Crash Bandicoot: The Huge Adventure,68,6,13,87,0.8505747126436781
Stygian: Reign of the Old Ones,65,9,13,87,0.8505747126436781
The Red Strings Club,125,23,26,174,0.8505747126436781
Ash of Gods: Redemption,120,28,26,174,0.8505747126436781
Mutant Year Zero: Road to Eden,392,63,80,535,0.8504672897196262
FIFA 22,198,1053,220,1471,0.8504418762746431
Depth,90,18,19,127,0.8503937007874016
Book of Demons,53,55,19,127,0.8503937007874016
MLB 14: The Show,214,53,47,314,0.8503184713375797
Bravely Default II,252,49,53,354,0.8502824858757062
Starfield,9726,5791,2733,18250,0.8502465753424657
Total War: Shogun 2,1158,89,220,1467,0.8500340831629175
Dead Horde,13,21,6,40,0.85
Wylde Flowers,31,3,6,40,0.85
The Case of the Golden Idol,28,6,6,40,0.85
Dragon Ball Z: Attack of the Saiyans,30,4,6,40,0.85
Someday You'll Return,45,6,9,60,0.85
Battle: Los Angeles,13,55,12,80,0.85
Mass Effect 3: Retaliation,23,11,6,40,0.85
Fist of the North Star: Ken's Rage 2,48,20,12,80,0.85
Izuna: Legend of the Unemployed Ninja,21,13,6,40,0.85
SNK 40th Anniversary Collection,24,10,6,40,0.85
Potentia,11,23,6,40,0.85
Cortex Command,90,29,21,140,0.85
Domina,29,39,12,80,0.85
Renowned Explorers: International Society,47,21,12,80,0.85
Company of Heroes 2: The British Forces,33,18,9,60,0.85
Thor: God of Thunder,68,34,18,120,0.85
Resident Evil 5: Lost in Nightmares,75,10,15,100,0.85
Untold Legends: Brotherhood of the Blade,33,1,6,40,0.85
Odin Sphere,48,3,9,60,0.85
Blade & Soul,98,140,42,280,0.85
Hyperdimension Neptunia Re;Birth1,187,34,39,260,0.85
Fighting EX Layer,32,19,9,60,0.85
Portal with RTX,20,14,6,40,0.85
Payday 3,88,252,60,400,0.85
Lair of the Clockwork God,28,6,6,40,0.85
Remnant II,354,127,85,566,0.8498233215547704
Toren,87,77,29,193,0.8497409326424871
Dust: An Elysian Tail,737,77,144,958,0.8496868475991649
Expeditions: Viking,97,16,20,133,0.849624060150376
Bee Simulator,56,40,17,113,0.8495575221238938
Mantis Burn Racing,59,20,14,93,0.8494623655913979
Outlast: Whistleblower,403,37,78,518,0.8494208494208494
Overwatch,5700,3055,1553,10308,0.8493403181994568
Harvest Moon 3D: A New Beginning,53,9,11,73,0.8493150684931506
Meet Your Maker,33,29,11,73,0.8493150684931506
Pro Evolution Soccer 2016,699,400,195,1294,0.8493044822256569
Life is Strange 2: Episode 2 - Rules,72,80,27,179,0.8491620111731844
Dungeonland,69,21,16,106,0.8490566037735849
Mages of Mystralia,34,11,8,53,0.8490566037735849
MLB The Show 20,93,42,24,159,0.8490566037735849
Story of Seasons: Pioneers of Olive Town,65,25,16,106,0.8490566037735849
Rhythm Thief & the Emperor's Treasure,41,4,8,53,0.8490566037735849
Young Justice: Legacy,21,24,8,53,0.8490566037735849
Ultimate Chicken Horse,82,8,16,106,0.8490566037735849
Don't Even Think,13,32,8,53,0.8490566037735849
Battlefield: Bad Company 2,1921,154,369,2444,0.8490180032733224
Yakuza Kiwami,741,91,148,980,0.8489795918367347
Kingdom Hearts III - Re Mind,115,76,34,225,0.8488888888888889
Fire Emblem Fates: Birthright,380,75,81,536,0.8488805970149254
Battlefield 1: They Shall Not Pass,42,31,13,86,0.8488372093023255
Mario & Luigi: Superstar Saga + Bowser's Minions,118,11,23,152,0.8486842105263158
Demon Slayer: Kimetsu no Yaiba - The Hinokami Chronicles,98,31,23,152,0.8486842105263158
Trinity: Souls of Zill O'll,23,5,5,33,0.8484848484848485
Avadon 2: The Corruption,24,4,5,33,0.8484848484848485
Air Conflicts: Vietnam,4,24,5,33,0.8484848484848485
Don't Starve: Reign of Giants,20,8,5,33,0.8484848484848485
Hyperdimension Neptunia Re;Birth2: Sisters Generation,63,21,15,99,0.8484848484848485
Harvest Moon: Light of Hope,13,43,10,66,0.8484848484848485
Dungeon Siege: Throne of Agony,25,3,5,33,0.8484848484848485
Girl Fight,12,16,5,33,0.8484848484848485
Zone of the Enders: The 2nd Runner,27,1,5,33,0.8484848484848485
Celestian Tales: Old North,8,20,5,33,0.8484848484848485
Plants vs Zombies: Garden Warfare 2,410,66,85,561,0.8484848484848485
ZEN Pinball 2: The Walking Dead,17,11,5,33,0.8484848484848485
Resonance of Fate 4K / HD Edition,20,8,5,33,0.8484848484848485
NBA JAM: On Fire Edition,48,8,10,66,0.8484848484848485
Disciples II: Guardians of the Light,25,3,5,33,0.8484848484848485
MechCommander 2,25,3,5,33,0.8484848484848485
Ash of Gods: The Way,23,5,5,33,0.8484848484848485
Iron Danger,23,5,5,33,0.8484848484848485
HARDCORE MECHA,20,8,5,33,0.8484848484848485
Cave Story Plus,296,34,59,389,0.8483290488431876
Resident Evil 7: biohazard - End of Zoe,100,23,22,145,0.8482758620689655
The Elder Scrolls III: Bloodmoon,88,7,17,112,0.8482142857142857
Sonic Generations,1353,122,264,1739,0.848188614146061
Transport Fever,56,11,12,79,0.8481012658227848
The Lord of the Rings Online: Riders of Rohan,51,16,12,79,0.8481012658227848
Desktop Dungeons,54,13,12,79,0.8481012658227848
Sky Force Reloaded,55,12,12,79,0.8481012658227848
Metro: 2033 Redux,1560,175,311,2046,0.8479960899315738
Yo-kai Watch,163,21,33,217,0.847926267281106
Lost Horizon,32,7,7,46,0.8478260869565217
Kohan: Immortal Sovereigns,35,4,7,46,0.8478260869565217
Victoria II,180,15,35,230,0.8478260869565217
Phantom Breaker: Battle Grounds,30,9,7,46,0.8478260869565217
Total War: PHARAOH,21,18,7,46,0.8478260869565217
Tales of Symphonia: Dawn of the New World,95,22,21,138,0.8478260869565217
Professor Layton VS Phoenix Wright Ace Attorney,144,12,28,184,0.8478260869565217
Dead or Alive Dimensions,106,11,21,138,0.8478260869565217
Ghostrunner,683,113,143,939,0.8477103301384451
Tony Hawk's Pro Skater 3,485,77,101,663,0.8476621417797888
Star Conflict,106,44,27,177,0.847457627118644
Trine 2: Goblin Menace,46,4,9,59,0.847457627118644
Monster Hunter Stories,91,9,18,118,0.847457627118644
Fatal Frame,96,4,18,118,0.847457627118644
LBX: Little Battlers eXperience,40,10,9,59,0.847457627118644
The Red Solstice,38,12,9,59,0.847457627118644
Dragon Quest IV: Chapters of the Chosen,47,3,9,59,0.847457627118644
Middle-earth: Shadow of War,1309,1501,506,3316,0.8474065138721351
Endless Space 2,137,24,29,190,0.8473684210526315
Crysis Remastered,168,176,62,406,0.8472906403940886
Final Fantasy Type-0,653,179,150,982,0.8472505091649695
Castlevania: Lords of Shadow 2,1052,207,227,1486,0.8472409152086138
Kentucky Route Zero,42,19,11,72,0.8472222222222222
Call of Duty: Ghosts - Invasion,31,30,11,72,0.8472222222222222
SOULVARS,68,4,13,85,0.8470588235294118
Guild Wars Factions,68,4,13,85,0.8470588235294118
Grand Theft Auto Double Pack,62,21,15,98,0.8469387755102041
Planetary Annihilation,188,166,64,418,0.84688995215311
Call of Duty: Black Ops 4,828,1897,493,3218,0.8467992541951522
Sid Meier's Civilization V,2285,262,461,3008,0.8467420212765957
FIFA 23,164,753,166,1083,0.8467220683287165
Black,223,9,42,274,0.8467153284671532
Kaze and the Wild Masks,99,17,21,137,0.8467153284671532
Adventure Time: Explore the Dungeon Because I DON'T KNOW!,50,77,23,150,0.8466666666666667
Vampire: The Masquerade - Swansong,42,107,27,176,0.8465909090909091
Exoprimal,130,228,65,423,0.8463356973995272
"Sakura Wars: So Long, My Love",51,4,10,65,0.8461538461538461
WarHawk,44,11,10,65,0.8461538461538461
Dead Rising 4,186,265,82,533,0.8461538461538461
Turok Remastered,57,9,12,78,0.8461538461538461
Coromon,28,5,6,39,0.8461538461538461
X-Men Legends,49,6,10,65,0.8461538461538461
SuperPower 2,31,2,6,39,0.8461538461538461
Elsword,46,20,12,78,0.8461538461538461
Silence: The Whispered World 2,129,36,30,195,0.8461538461538461
Grandia II Anniversary Edition,28,5,6,39,0.8461538461538461
Ashen,267,140,74,481,0.8461538461538461
No More Heroes 2: Desperate Struggle,155,10,30,195,0.8461538461538461
Megaton Rainfall,23,10,6,39,0.8461538461538461
The Jackbox Party Pack 3,38,6,8,52,0.8461538461538461
Command & Conquer: Tiberian Sun - Firestorm,32,1,6,39,0.8461538461538461
198X,34,21,10,65,0.8461538461538461
Drawing From Memory,30,3,6,39,0.8461538461538461
Penumbra: Black Plague,170,6,32,208,0.8461538461538461
Predator: Hunting Grounds,187,165,64,416,0.8461538461538461
Atelier Meruru: The Apprentice of Arland,98,12,20,130,0.8461538461538461
Battlezone,35,9,8,52,0.8461538461538461
Pikmin 1 + 2,51,4,10,65,0.8461538461538461
"Flower, Sun, and Rain",32,1,6,39,0.8461538461538461
Clash: Artifacts of Chaos,17,16,6,39,0.8461538461538461
The Pathless,183,37,40,260,0.8461538461538461
Pokemon Sun,893,212,201,1306,0.8460949464012251
Pillars of Eternity: Complete Edition,122,92,39,253,0.8458498023715415
Hyrule Warriors,658,66,132,856,0.8457943925233645
Bubsy: The Woolies Strike Back,76,72,27,175,0.8457142857142858
Top Spin 4,135,13,27,175,0.8457142857142858
Final Fantasy XI,97,29,23,149,0.8456375838926175
Drawn to Death,73,53,23,149,0.8456375838926175
Life is Strange: Before the Storm - Farewell,105,21,23,149,0.8456375838926175
Unavowed,91,13,19,123,0.8455284552845529
Paper Mario: The Origami King,1129,398,279,1806,0.845514950166113
Nioh 2 Remastered: The Complete Edition,83,10,17,110,0.8454545454545455
Killer Instinct,395,212,111,718,0.8454038997214485
Dead or Alive 5 Last Round,329,92,77,498,0.8453815261044176
Batman: Arkham Knight - Season of Infamy: Most Wanted,70,12,15,97,0.845360824742268
Destroy All Humans! 2 - Reprobed,60,11,13,84,0.8452380952380952
AEW: Fight Forever,76,66,26,168,0.8452380952380952
Narcos: Rise of the Cartels,8,52,11,71,0.8450704225352113
Hogs of War,57,3,11,71,0.8450704225352113
Dragon Quest VI: Realms of Revelation,54,6,11,71,0.8450704225352113
Total War: Rome II,1192,2178,618,3988,0.8450351053159478
THE FINALS,82,27,20,129,0.8449612403100775
Yooka-Laylee and the Impossible Lair,229,76,56,361,0.8448753462603878
Professor Layton and the Azran Legacy,87,11,18,116,0.8448275862068966
Shadow of Destiny,43,6,9,58,0.8448275862068966
Deception IV: The Nightmare Princess,36,13,9,58,0.8448275862068966
Life is Feudal: Your Own,28,21,9,58,0.8448275862068966
After Us,38,11,9,58,0.8448275862068966
Etrian Mystery Dungeon,42,7,9,58,0.8448275862068966
Hearts of Iron IV,743,133,161,1037,0.8447444551591128
Star Wars Galaxies: Jump to Lightspeed,77,10,16,103,0.8446601941747572
Pokemon White Version,581,98,125,804,0.8445273631840796
Bloodbath Kavkaz,38,38,14,90,0.8444444444444444
Starblood Arena,29,9,7,45,0.8444444444444444
Driveclub VR,80,34,21,135,0.8444444444444444
Lightseekers,31,7,7,45,0.8444444444444444
Legend of Mana Remastered,31,7,7,45,0.8444444444444444
Scooby-Doo! and the Spooky Swamp,36,2,7,45,0.8444444444444444
Sorcery Saga: The Curse of the Great Curry God,29,9,7,45,0.8444444444444444
Fragile Dreams: Farewell Ruins of the Moon,36,2,7,45,0.8444444444444444
Criminal Girls: Invite Only,27,11,7,45,0.8444444444444444
Hyperdevotion Noire: Goddess Black Heart,28,10,7,45,0.8444444444444444
Amnesia: The Bunker,144,24,31,199,0.8442211055276382
Wizard of Legend,109,21,24,154,0.8441558441558441
Jagged Alliance: Flashback,19,46,12,77,0.8441558441558441
Shantae: Half-Genie Hero - Ultimate Edition,114,16,24,154,0.8441558441558441
Teenage Mutant Ninja Turtles: The Cowabunga Collection,51,14,12,77,0.8441558441558441
I Expect You To Die,55,10,12,77,0.8441558441558441
Destiny: The Dark Below,54,260,58,372,0.8440860215053764
Star Wars: Rogue Squadron 3D,88,4,17,109,0.8440366972477065
NHL Hitz 20-02,236,40,51,327,0.8440366972477065
Tetris Effect: Connected,286,60,64,410,0.8439024390243902
Enter the Gungeon,762,81,156,999,0.8438438438438438
Kirby's Adventure,49,5,10,64,0.84375
Grabbed by the Ghoulies,25,2,5,32,0.84375
Stolen (2005),19,8,5,32,0.84375
Bloody Good Time,22,5,5,32,0.84375
Unchained Blades,22,5,5,32,0.84375
Velocity,22,5,5,32,0.84375
Typoman,21,6,5,32,0.84375
Ni no Kuni: Wrath of the White Witch Remastered,211,32,45,288,0.84375
The End Is Nigh,90,18,20,128,0.84375
Nintendo Pocket Football Club,24,3,5,32,0.84375
Super Ultra Dead Rising 3' Arcade Remix Hyper Edition EX Plus Alpha,17,10,5,32,0.84375
.detuned,5,22,5,32,0.84375
Song of Saya - Saya no Uta,25,2,5,32,0.84375
Tiger Woods PGA Tour 10,11,16,5,32,0.84375
Shantae: Half-Genie Hero,269,44,58,371,0.8436657681940701
Need for Speed: Porsche Unleashed,168,10,33,211,0.8436018957345972
Dying Light,3776,431,780,4987,0.8435933426909966
NHL 22,40,84,23,147,0.8435374149659864
Mass Effect: Andromeda,3970,4413,1556,9939,0.8434450145889929
Need for Speed Payback,688,1271,364,2323,0.8433060697374085
Iron Brigade,90,23,21,134,0.8432835820895522
Quantum Break,2013,801,523,3337,0.8432724003596045
Donkey Kong 64,259,10,50,319,0.8432601880877743
ArmA II: Operation Arrowhead,140,16,29,185,0.8432432432432433
"Gabriel Knight 3: Blood of the Sacred, Blood of the Damned",38,5,8,51,0.8431372549019608
LEGRAND LEGACY: Tale of the Fatebounds,27,16,8,51,0.8431372549019608
Star Fox Guard,68,18,16,102,0.8431372549019608
TowerFall Ascension,429,146,107,682,0.843108504398827
"Warhammer 40,000: Inquisitor - Martyr",120,68,35,223,0.8430493273542601
Skylanders Imaginators,85,60,27,172,0.8430232558139535
The Wolf Among Us: Episode 2 - Smoke and Mirrors,392,43,81,516,0.8430232558139535
Kirby's Epic Yarn,252,11,49,312,0.842948717948718
Cocoon,230,33,49,312,0.842948717948718
Resonance of Fate,148,13,30,191,0.8429319371727748
Tom Clancy's Rainbow Six 3: Raven Shield,54,5,11,70,0.8428571428571429
Tony Hawk's Pro Skater,114,4,22,140,0.8428571428571429
Syphon Filter,186,7,36,229,0.8427947598253275
Kentucky Route Zero - Act III,101,49,28,178,0.8426966292134831
Driveclub Bikes,85,22,20,127,0.84251968503937
Super Meat Boy Forever,60,79,26,165,0.8424242424242424
Pokemon X,1096,239,250,1585,0.8422712933753943
Rayman 2: The Great Escape,282,33,59,374,0.8422459893048129
Immortals Fenyx Rising,1075,227,244,1546,0.8421733505821475
TrackMania 2 Canyon,79,17,18,114,0.8421052631578947
Tooth and Tail,41,7,9,57,0.8421052631578947
Smash Court Tennis Pro Tournament,73,7,15,95,0.8421052631578947
StarCraft II: Nova Covert Ops - Mission Pack 1,48,16,12,76,0.8421052631578947
Legend of Kay Anniversary,55,25,15,95,0.8421052631578947
DARQ,41,7,9,57,0.8421052631578947
BONELAB,24,8,6,38,0.8421052631578947
Red Orchestra: Ostfront 41-45,72,8,15,95,0.8421052631578947
Grand Theft Auto (Game Boy Advance),22,42,12,76,0.8421052631578947
Airfix Dogfighter,27,5,6,38,0.8421052631578947
Kirby Fighters 2,28,4,6,38,0.8421052631578947
The Legend of Zelda: Skyward Sword HD,522,128,122,772,0.8419689119170984
Beyond: Two Souls,3332,513,722,4567,0.841909349682505
Call of Duty: Warzone Caldera,474,1033,283,1790,0.8418994413407821
Diablo III,3524,6003,1791,11318,0.8417564940802262
UEFA Euro 2012,17,68,16,101,0.8415841584158416
DAVE THE DIVER,217,22,45,284,0.8415492957746479
Wolfenstein II: The New Colossus,2733,803,666,4202,0.8415040456925273
Ruined King: A League of Legends Story,162,45,39,246,0.8414634146341463
Divinity II: The Dragon Knight Saga,224,20,46,290,0.8413793103448276
The Smurfs 2,28,25,10,63,0.8412698412698413
Door Kickers,92,14,20,126,0.8412698412698413
Bubsy: Paws on Fire,110,33,27,170,0.8411764705882353
Lost Ark,254,270,99,623,0.841091492776886
The Simpsons: Hit & Run,373,8,72,453,0.8410596026490066
Hello Neighbor,185,270,86,541,0.8410351201478743
The Walking Dead: Season Two - A Telltale Games Series,1158,101,238,1497,0.8410153640614563
Mobile Suit Gundam: Battle Operation 2,18,19,7,44,0.8409090909090909
Disney Frozen Free Fall: Snowball Fight,11,26,7,44,0.8409090909090909
This War of Mine,1116,105,231,1452,0.8409090909090909
Dying: Reborn,13,24,7,44,0.8409090909090909
Insomnis,28,9,7,44,0.8409090909090909
The friends of Ringo Ishikawa,25,12,7,44,0.8409090909090909
Warlords Battlecry II,33,4,7,44,0.8409090909090909
Conqueror's Blade,17,20,7,44,0.8409090909090909
Forza Horizon 4: LEGO Speed Champions,48,26,14,88,0.8409090909090909
The Darkside Detective: A Fumble in the Dark,33,4,7,44,0.8409090909090909
Chorus,138,47,35,220,0.8409090909090909
Metro Exodus: The Two Colonels,108,24,25,157,0.8407643312101911
The Elder Scrolls: Chapter II - Daggerfall,105,11,22,138,0.8405797101449275
The Book of Unwritten Tales,129,8,26,163,0.8404907975460123
LocoCycle,32,68,19,119,0.8403361344537815
Return to Monkey Island,244,61,58,363,0.8402203856749312
Pokemon Y,1016,225,236,1477,0.8402166553825322
Madden NFL 2005,32,10,8,50,0.84
PaRappa the Rapper,113,55,32,200,0.84
Ikenfell,34,8,8,50,0.84
Robinson: The Journey,59,25,16,100,0.84
Star Wars: The Old Republic - Rise of the Hutt Cartel,31,11,8,50,0.84
Rumbleverse,16,26,8,50,0.84
Pokemon Ruby Version,306,14,61,381,0.8398950131233596
Total War: Attila,452,104,106,662,0.8398791540785498
RuneScape 3,71,39,21,131,0.8396946564885496
Tekken 5: Dark Resurrection,137,20,30,187,0.839572192513369
Ancestors: The Humankind Odyssey,171,143,60,374,0.839572192513369
Kingdom Hearts: Chain of Memories,207,18,43,268,0.8395522388059702
Alekhine's Gun,42,94,26,162,0.8395061728395061
Crawl,59,9,13,81,0.8395061728395061
Darksiders Genesis,424,78,96,598,0.8394648829431438
Risk of Rain,287,37,62,386,0.8393782383419689
Sonic Colors: Ultimate,303,188,94,585,0.8393162393162393
Tiny Tina's Wonderlands,262,218,92,572,0.8391608391608392
Sid Meier's Pirates!,226,14,46,286,0.8391608391608392
League of Legends,1819,2186,768,4773,0.8390949088623507
Graceful Explosion Machine,63,10,14,87,0.8390804597701149
Yooka-Laylee,506,260,147,913,0.8389923329682366
Wii Sports Resort,266,10,53,329,0.8389057750759878
Fallout 3,5463,650,1174,7287,0.8388911760669686
Disney Infinity 3.0 Edition,92,59,29,180,0.8388888888888889
Pokemon Black Version,678,103,150,931,0.8388829215896885
Full Throttle,171,6,34,211,0.8388625592417062
Jet Set Radio (2000),265,68,64,397,0.8387909319899244
Urban Champion,12,14,5,31,0.8387096774193549
Chili Con Carnage,23,3,5,31,0.8387096774193549
Bad Bots,20,6,5,31,0.8387096774193549
Super Cloudbuilt,20,6,5,31,0.8387096774193549
Child of Light,1616,204,350,2170,0.8387096774193549
Streets of Rage 2,92,12,20,124,0.8387096774193549
Virtua Fighter 4,49,3,10,62,0.8387096774193549
Rage of Mages II: Necromancer,24,2,5,31,0.8387096774193549
First Class Trouble,10,42,10,62,0.8387096774193549
Ty the Tasmanian Tiger HD,22,4,5,31,0.8387096774193549
The Sims 4: Get to Work,71,59,25,155,0.8387096774193549
Ace Combat: Assault Horizon Legacy,21,5,5,31,0.8387096774193549
Microsoft Flight Simulator 2004: A Century of Flight,21,5,5,31,0.8387096774193549
Thumper,209,51,50,310,0.8387096774193549
The Perils of Man,16,10,5,31,0.8387096774193549
Super Daryl Deluxe,18,8,5,31,0.8387096774193549
Cricket 22,15,11,5,31,0.8387096774193549
Sonic Rush,149,12,31,192,0.8385416666666666
Candle,69,14,16,99,0.8383838383838383
Skate 3,263,17,54,334,0.8383233532934131
WWI: Verdun - Western Front,158,44,39,241,0.8381742738589212
Yoshi's Crafted World,283,38,62,383,0.8381201044386423
Horizon Zero Dawn: Complete Edition,1146,288,277,1711,0.8381063705435418
Burnout Legends,80,8,17,105,0.8380952380952381
Monster Energy Supercross - The Official Videogame,36,52,17,105,0.8380952380952381
Metal Slug X,114,5,23,142,0.8380281690140845
Dead or Alive 5,230,39,52,321,0.838006230529595
Dragon Age: Inquisition - Trespasser,148,33,35,216,0.8379629629629629
Lunar: Silver Star Harmony,29,2,6,37,0.8378378378378378
Samurai Warriors Chronicles 3,24,7,6,37,0.8378378378378378
Unity of Command II,24,7,6,37,0.8378378378378378
Don Bradman Cricket 14,102,22,24,148,0.8378378378378378
GamersGoMakers,25,6,6,37,0.8378378378378378
Vasara Collection,24,7,6,37,0.8378378378378378
Star Wars: Episode I Battle for Naboo,27,4,6,37,0.8378378378378378
EVE: Valkyrie,54,39,18,111,0.8378378378378378
Danganronpa S: Ultimate Summer Camp,12,19,6,37,0.8378378378378378
Diabotical,27,4,6,37,0.8378378378378378
Doug Flutie's Maximum Football 2020,17,14,6,37,0.8378378378378378
Shining Resonance Refrain,128,32,31,191,0.837696335078534
Xenonauts,141,24,32,197,0.8375634517766497
Sanctum 2,291,106,77,474,0.8375527426160337
Madden NFL 2003,44,23,13,80,0.8375
X4: Foundations,82,52,26,160,0.8375
Wii Fit U,57,10,13,80,0.8375
Terminator: Resistance,444,66,99,609,0.8374384236453202
Men of War,94,9,20,123,0.8373983739837398
Company of Heroes 2: The Western Front Armies,75,28,20,123,0.8373983739837398
Trackmania,51,88,27,166,0.8373493975903614
Crimecraft: Bleedout,16,20,7,43,0.8372093023255814
DreamWorks Over the Hedge,33,3,7,43,0.8372093023255814
Gray Dawn,29,7,7,43,0.8372093023255814
Sonic Forces: Episode Shadow,53,19,14,86,0.8372093023255814
Metal Gear Solid: Master Collection Vol. 1,37,71,21,129,0.8372093023255814
Capcom Arcade Stadium,24,12,7,43,0.8372093023255814
Vigor,66,42,21,129,0.8372093023255814
DOOM 3 BFG Edition,577,199,151,927,0.837108953613808
Mordheim: City of the Damned,77,36,22,135,0.837037037037037
Hyperdimension Neptunia,78,35,22,135,0.837037037037037
Tom Clancy's Ghost Recon Phantoms,144,87,45,276,0.8369565217391305
SoulCalibur: Lost Swords,4,73,15,92,0.8369565217391305
MediEvil: Resurrection,72,5,15,92,0.8369565217391305
Command & Conquer: Generals,261,11,53,325,0.8369230769230769
Rayman 3: Hoodlum Havoc,251,21,53,325,0.8369230769230769
Below,66,52,23,141,0.8368794326241135
Psychonauts in The Rhombus of Ruin,34,7,8,49,0.8367346938775511
SUPERBEAT: XONiC,31,10,8,49,0.8367346938775511
If Found...,28,13,8,49,0.8367346938775511
Left 4 Dead 2: The Sacrifice,37,4,8,49,0.8367346938775511
Atelier Ayesha: The Alchemist of Dusk,105,18,24,147,0.8367346938775511
XCOM 2,1563,420,387,2370,0.8367088607594937
Warframe,2013,333,458,2804,0.8366619115549215
Captain Tsubasa: Rise of New Champions,129,40,33,202,0.8366336633663366
New Super Lucky's Tale,134,35,33,202,0.8366336633663366
ATOM RPG,142,27,33,202,0.8366336633663366
Outlast,2568,227,546,3341,0.8365758754863813
Call of Duty: Warzone,66,323,76,465,0.8365591397849462
Legends of Runeterra,121,53,34,208,0.8365384615384616
Fate/Extella Link,66,21,17,104,0.8365384615384616
Scars Above,60,27,17,104,0.8365384615384616
The Dream Machine,43,3,9,55,0.8363636363636363
Arc the Lad: Twilight of the Spirits,40,6,9,55,0.8363636363636363
Dead or Alive 3,44,2,9,55,0.8363636363636363
Ancestors Legacy,112,31,28,171,0.8362573099415205
Sonic Origins,163,77,47,287,0.8362369337979094
Story of Seasons: A Wonderful Life,41,10,10,61,0.8360655737704918
Steel Division 2,37,14,10,61,0.8360655737704918
"Pokemon: Let's Go, Eevee!",616,327,185,1128,0.8359929078014184
Lords of Xulima,93,14,21,128,0.8359375
F1 2019,177,37,42,256,0.8359375
Prince of Persia: The Sands of Time,1017,32,206,1255,0.8358565737051793
"WarioWare, Inc.: Mega Microgame$!",55,1,11,67,0.835820895522388
Dragon Ball Z: Budokai Tenkaichi 2,108,4,22,134,0.835820895522388
Cabela's Dangerous Hunts 2013,23,33,11,67,0.835820895522388
Battle Chef Brigade,48,8,11,67,0.835820895522388
Call of Duty: United Offensive,265,20,56,341,0.8357771260997068
Remothered: Tormented Fathers,139,39,35,213,0.8356807511737089
Far Cry 6 - Vaas: Insanity,21,40,12,73,0.8356164383561644
Story of Seasons,53,8,12,73,0.8356164383561644
Transport Fever 2,55,11,13,79,0.8354430379746836
DreamWorks Bee Movie Game,116,21,27,164,0.8353658536585366
NBA 2K23,78,145,44,267,0.8352059925093633
The Lord of the Rings: The Battle for Middle-Earth II,363,12,74,449,0.8351893095768375
Age of Empires III: Complete Collection,73,3,15,91,0.8351648351648352
Metin2,32,44,15,91,0.8351648351648352
Planet of Lana,203,30,46,279,0.8351254480286738
Water Warfare,67,14,16,97,0.8350515463917526
Age of Wonders II: The Wizard's Throne,76,5,16,97,0.8350515463917526
Neighbors From Hell,79,7,17,103,0.8349514563106796
"Pokemon: Let's Go, Pikachu!",977,549,302,1828,0.8347921225382933
VOEZ,84,12,19,115,0.8347826086956521
Genesis Alpha One,39,62,20,121,0.8347107438016529
Ravenlok,78,38,23,139,0.8345323741007195
Viva Pinata,100,16,23,139,0.8345323741007195
SWAT 4,238,4,48,290,0.8344827586206897
Battlefield 3: Back to Karkand,212,50,52,314,0.8343949044585988
Bugsnax,398,100,99,597,0.8341708542713567
The Walking Dead: Survival Instinct,182,653,166,1001,0.8341658341658341
The Sims 2,813,47,171,1031,0.8341416100872939
Mass Effect 3: Extended Cut,146,65,42,253,0.83399209486166
Chrono Cross: The Radical Dreamers Edition,311,45,71,427,0.8337236533957846
Tales of Vesperia: Definitive Edition,299,62,72,433,0.8337182448036952
Castlevania: Lords of Shadow - Ultimate Edition,440,106,109,655,0.833587786259542
Men of War: Assault Squad,86,14,20,120,0.8333333333333334
Picross 3D,32,3,7,42,0.8333333333333334
EVE Online: Incarna,5,20,5,30,0.8333333333333334
Impact Winter,36,9,9,54,0.8333333333333334
Falling Skies: The Game,7,23,6,36,0.8333333333333334
Earth Defense Force 2025,92,18,22,132,0.8333333333333334
Pokemon Puzzle League,33,2,7,42,0.8333333333333334
King's Quest Chapter 1: A Knight to Remember,164,41,41,246,0.8333333333333334
SimCity 3000,30,5,7,42,0.8333333333333334
Outlaws,28,2,6,36,0.8333333333333334
Mario + Rabbids Sparks of Hope,192,43,47,282,0.8333333333333334
Starfield: Premium Edition Upgrade,15,10,5,30,0.8333333333333334
R-Type Dimensions,30,10,8,48,0.8333333333333334
FlatOut: Head On,28,2,6,36,0.8333333333333334
LUNA The Shadow Dust,32,13,9,54,0.8333333333333334
Bejeweled 3,110,15,25,150,0.8333333333333334
Big Bumpin',16,9,5,30,0.8333333333333334
Sin & Punishment: Star Successor,77,3,16,96,0.8333333333333334
F1 2017,167,38,41,246,0.8333333333333334
Armillo,35,5,8,48,0.8333333333333334
Star Control: Origins,55,40,19,114,0.8333333333333334
Harvest Moon 64,38,2,8,48,0.8333333333333334
Far Cry 5: Dead Living Zombies,21,49,14,84,0.8333333333333334
Tangle Tower,29,6,7,42,0.8333333333333334
Five Nights at Freddy's HD,27,8,7,42,0.8333333333333334
Ooblets,16,9,5,30,0.8333333333333334
Citizen Sleeper,58,12,14,84,0.8333333333333334
Patapon 2,67,3,14,84,0.8333333333333334
Lonely Mountains: Downhill,88,32,24,144,0.8333333333333334
Tom Clancy's Ghost Recon Advanced Warfighter,100,5,21,126,0.8333333333333334
Myst V: End of Ages,25,10,7,42,0.8333333333333334
Ape Escape 3,34,1,7,42,0.8333333333333334
.hack//Infection Part 1,22,3,5,30,0.8333333333333334
Making History: The Calm and the Storm,25,5,6,36,0.8333333333333334
DEADBOLT,35,10,9,54,0.8333333333333334
Resident Evil 0: HD Remaster,683,82,153,918,0.8333333333333334
Grand Kingdom,102,23,25,150,0.8333333333333334
Breath of Fire III,33,2,7,42,0.8333333333333334
Inazuma Eleven 3: Team Ogre Attacks!,22,3,5,30,0.8333333333333334
Pode,21,9,6,36,0.8333333333333334
Gundam Evolution,14,16,6,36,0.8333333333333334
Dragon Quest Treasures,38,22,12,72,0.8333333333333334
1971 Project Helios,18,7,5,30,0.8333333333333334
Sonic Mega Collection Plus,44,1,9,54,0.8333333333333334
Syphon Filter: Dark Mirror,74,16,18,108,0.8333333333333334
Miner Wars 2081,36,24,12,72,0.8333333333333334
Star Wars Battlefront: Renegade Squadron,54,1,11,66,0.8333333333333334
Brute Force,22,3,5,30,0.8333333333333334
Primal,47,3,10,60,0.8333333333333334
Sparc,20,5,5,30,0.8333333333333334
BYE-BYE BOXBOY!,21,4,5,30,0.8333333333333334
Lumino City,34,6,8,48,0.8333333333333334
Test Drive Le Mans,30,5,7,42,0.8333333333333334
Astebreed,104,31,27,162,0.8333333333333334
Might and Magic VIII: Day of the Destroyer,38,2,8,48,0.8333333333333334
Middle-earth: Shadow of War - Desolation of Mordor,16,19,7,42,0.8333333333333334
Monster Prom,25,10,7,42,0.8333333333333334
Dark Deception,20,5,5,30,0.8333333333333334
The Tale of Bistun,27,3,6,36,0.8333333333333334
Vampire: The Masquerade - Bloodhunt,58,32,18,108,0.8333333333333334
9 Years of Shadows,24,6,6,36,0.8333333333333334
Marvel's Spider-Man: Miles Morales - Ultimate Edition,44,6,10,60,0.8333333333333334
The Wild At Heart,36,4,8,48,0.8333333333333334
Knights in the Nightmare,17,8,5,30,0.8333333333333334
The Lord of the Rings Online: Mines of Moria,43,12,11,66,0.8333333333333334
Wizard101,42,23,13,78,0.8333333333333334
OVERPASS,8,27,7,42,0.8333333333333334
Pac-Man World 3,373,16,78,467,0.8329764453961456
Fortnite,1367,2622,800,4789,0.8329505115890583
Destiny 2: Shadowkeep,191,158,70,419,0.8329355608591885
Tyranny,474,84,112,670,0.8328358208955224
Dishonored: Death of the Outsider,705,122,166,993,0.8328298086606244
Gears of War,1691,147,369,2207,0.8328047122791119
Senran Kagura Shinovi Versus,130,29,32,191,0.8324607329842932
The Elder Scrolls Online,1216,1056,458,2730,0.8322344322344323
Car Mechanic Simulator 2015,99,10,22,131,0.8320610687022901
Resogun,815,131,191,1137,0.832014072119613
Minecraft: Story Mode - Episode 3: The Last Place You Look,66,38,21,125,0.832
Plants vs Zombies: Garden Warfare,848,172,206,1226,0.831973898858075
Miitopia,177,21,40,238,0.8319327731092437
NBA Live 19,66,33,20,119,0.8319327731092437
ELEX II,132,56,38,226,0.831858407079646
Guitar Hero,84,5,18,107,0.8317757009345794
Star Trek: Starfleet Command III,78,11,18,107,0.8317757009345794
RIDE 3,54,35,18,107,0.8317757009345794
LEGO Star Wars: The Skywalker Saga,512,91,122,725,0.8317241379310345
Street Fighter V: Arcade Edition,286,134,85,505,0.8316831683168316
Metro: Last Light Redux,787,122,184,1093,0.8316559926806953
Tumblestone,31,48,16,95,0.8315789473684211
Sid Meier's Civilization V: Gods & Kings,326,54,77,457,0.8315098468271335
Disintegration,34,40,15,89,0.8314606741573034
Onimusha: Dawn of Dreams,66,3,14,83,0.8313253012048193
Skylanders Trap Team,90,43,27,160,0.83125
Pokemon UNITE,108,217,66,391,0.8312020460358056
Hitman 2: Silent Assassin,481,31,104,616,0.8311688311688312
Escape Dead Island,43,144,38,225,0.8311111111111111
Bladestorm: Nightmare,42,17,12,71,0.8309859154929577
Deadly Premonition 2: A Blessing in Disguise,88,84,35,207,0.8309178743961353
Shadowrun: Hong Kong,186,30,44,260,0.8307692307692308
Battlefield 1,4293,899,1059,6251,0.8305871060630299
We Love Katamari,48,1,10,59,0.8305084745762712
Unto The End,23,26,10,59,0.8305084745762712
Sword Art Online: Fatal Bullet,144,47,39,230,0.8304347826086956
Cossacks: European Wars,84,9,19,112,0.8303571428571429
Tokyo Jungle,84,9,19,112,0.8303571428571429
Marvel's Spider-Man: Miles Morales,3418,633,828,4879,0.8302930928468949
Ar tonelico: Melody of Elemia,39,5,9,53,0.8301886792452831
The Walking Dead: Season Two Episode 4 - Amid the Ruins,265,43,63,371,0.8301886792452831
Super Seducer: How to Talk to Girls,29,15,9,53,0.8301886792452831
The Night of the Rabbit,72,16,18,106,0.8301886792452831
Runbow,71,17,18,106,0.8301886792452831
The Last Oricru,33,11,9,53,0.8301886792452831
Pokemon Diamond Version,441,43,99,583,0.8301886792452831
MLB The Show 22,70,57,26,153,0.8300653594771242
WHAT THE GOLF?,74,9,17,100,0.83
Unepic,244,39,58,341,0.8299120234604106
Dark Messiah of Might and Magic,422,22,91,535,0.8299065420560747
Empire Earth,157,4,33,194,0.8298969072164949
Earthworm Jim,33,6,8,47,0.8297872340425532
Star Renegades,25,14,8,47,0.8297872340425532
Way of the Samurai 3,28,11,8,47,0.8297872340425532
Crashlands,92,25,24,141,0.8297872340425532
Taz Wanted,37,2,8,47,0.8297872340425532
Duke Nukem 3D: 20th Anniversary World Tour,88,24,23,135,0.8296296296296296
Risen 3: Titan Lords,537,456,204,1197,0.8295739348370927
Battle Worlds: Kronos,52,21,15,88,0.8295454545454546
Pid,63,10,15,88,0.8295454545454546
Wasteland 3,588,136,149,873,0.8293241695303551
Breath of Fire: Dragon Quarter,23,11,7,41,0.8292682926829268
State of Decay 2:  Juggernaut Edition,29,5,7,41,0.8292682926829268
Real Steel,24,10,7,41,0.8292682926829268
The Sims 4: Seasons,41,27,14,82,0.8292682926829268
Hearthstone: Heroes of Warcraft - League of Explorers,35,33,14,82,0.8292682926829268
Skylanders: Spyro's Adventure,128,105,48,281,0.8291814946619217
Mortal Kombat 11 Ultimate,480,155,131,766,0.8289817232375979
The Crew Motorfest,280,69,72,421,0.828978622327791
Marvel's Guardians of the Galaxy - Episode 2: Under Pressure,31,32,13,76,0.8289473684210527
Finny the Fish & the Seven Waters,59,4,13,76,0.8289473684210527
Wasteland 2,786,222,208,1216,0.8289473684210527
Pokken Tournament DX,195,52,51,298,0.8288590604026845
Little Nightmares: Complete Edition,214,33,51,298,0.8288590604026845
Naruto Shippuden: Ultimate Ninja Storm 2,227,20,51,298,0.8288590604026845
Pokemon Shield,1179,1740,603,3522,0.8287904599659285
Trine 2,687,53,153,893,0.8286674132138858
Starlink: Battle for Atlas,215,51,55,321,0.8286604361370716
Valkyria Revolution,59,57,24,140,0.8285714285714286
The Metronomicon: Slay the Dance Floor,21,8,6,35,0.8285714285714286
Azur Lane: Crosswave,19,10,6,35,0.8285714285714286
Mario Superstar Baseball,28,1,6,35,0.8285714285714286
Code Vein,891,182,222,1295,0.8285714285714286
The Mortuary Assistant,8,21,6,35,0.8285714285714286
Tokyo Dark,23,6,6,35,0.8285714285714286
Hitman: Game of the Year Edition,21,8,6,35,0.8285714285714286
Okage: Shadow King,23,6,6,35,0.8285714285714286
Bushido Blade,26,3,6,35,0.8285714285714286
Time Commando,24,5,6,35,0.8285714285714286
My Hero One's Justice 2,43,44,18,105,0.8285714285714286
FlatOut: Ultimate Carnage,154,15,35,204,0.8284313725490197
NBA 2K13,329,86,86,501,0.8283433133732535
SNK Heroines: Tag Team Frenzy,51,31,17,99,0.8282828282828283
Hello Neighbor 2,28,54,17,99,0.8282828282828283
Sonic & Sega All-Stars Racing,208,9,45,262,0.8282442748091603
West of Loathing,117,18,28,163,0.8282208588957055
Metal Gear Solid: Peace Walker HD Edition,90,16,22,128,0.828125
Gunman Clive HD Collection,46,7,11,64,0.828125
The Outer Worlds: Spacer's Choice Edition,24,29,11,64,0.828125
Warhammer: End Times - Vermintide,258,60,66,384,0.828125
Earth Defense Force 5,45,8,11,64,0.828125
Dragon Nest,41,12,11,64,0.828125
Earth 2150,47,6,11,64,0.828125
The Crew: Wild Run,72,34,22,128,0.828125
Command & Conquer 3: Tiberium Wars,317,20,70,407,0.828009828009828
Skate 2,96,5,21,122,0.8278688524590164
Grim Fandango Remastered,581,97,141,819,0.8278388278388278
Shantae and the Seven Sirens,106,19,26,151,0.8278145695364238
The Last Case of Benedict Fox,94,31,26,151,0.8278145695364238
Final Fantasy VII: Advent Children,142,26,35,203,0.8275862068965517
Burnout 2: Point of Impact,70,2,15,87,0.8275862068965517
Castlevania: Lament of Innocence,70,2,15,87,0.8275862068965517
Only If,26,22,10,58,0.8275862068965517
Ape Escape 2,45,3,10,58,0.8275862068965517
Frostpunk: The Last Autumn,47,1,10,58,0.8275862068965517
Wallace & Gromit: The Curse of the Were-Rabbit,11,37,10,58,0.8275862068965517
Dropsy,38,10,10,58,0.8275862068965517
Evolve,672,1209,392,2273,0.827540695116586
The Banner Saga 2,258,25,59,342,0.827485380116959
A Way Out,1521,215,362,2098,0.8274547187797903
Super Smash Bros.,387,6,82,475,0.8273684210526315
Injustice: Gods Among Us,666,72,154,892,0.827354260089686
NCAA Football 14,77,38,24,139,0.8273381294964028
Mount & Blade II: Bannerlord,201,29,48,278,0.8273381294964028
Naruto Shippuden: Ultimate Ninja Storm 3,250,42,61,353,0.8271954674220963
Digimon World 2,59,8,14,81,0.8271604938271605
Scarface: The World Is Yours,147,6,32,185,0.827027027027027
Warriors Orochi,35,8,9,52,0.8269230769230769
Biped,75,11,18,104,0.8269230769230769
Ridge Racer 7,37,6,9,52,0.8269230769230769
Ittle Dew 2,36,7,9,52,0.8269230769230769
Flipping Death,30,13,9,52,0.8269230769230769
Muck,38,5,9,52,0.8269230769230769
Just Dance 3,35,8,9,52,0.8269230769230769
Exist Archive: The Other Side of the Sky,34,9,9,52,0.8269230769230769
Kirby's Extra Epic Yarn,31,12,9,52,0.8269230769230769
Tails of Iron,148,24,36,208,0.8269230769230769
Gundam Versus,28,15,9,52,0.8269230769230769
The Council - Episode 2: Hide and Seek,35,8,9,52,0.8269230769230769
NBA 2K15,328,202,111,641,0.8268330733229329
Stealth Bastard Deluxe,54,8,13,75,0.8266666666666667
Mario Kart 7,766,40,169,975,0.8266666666666667
Rift: Storm Legion,51,11,13,75,0.8266666666666667
Tiger Woods PGA Tour 12: The Masters,33,29,13,75,0.8266666666666667
Gorogoa,238,29,56,323,0.826625386996904
Momodora: Reverie Under the Moonlight,123,20,30,173,0.8265895953757225
Cris Tales,113,30,30,173,0.8265895953757225
Elemental: Fallen Enchantress,113,30,30,173,0.8265895953757225
Command & Conquer 3: Kane's Wrath,134,9,30,173,0.8265895953757225
Gungrave G.O.R.E,38,43,17,98,0.826530612244898
Pinball FX3,65,16,17,98,0.826530612244898
Into the Breach,486,71,117,674,0.8264094955489614
The Wonderful 101: Remastered,90,29,25,144,0.8263888888888888
The Witness,1084,300,291,1675,0.8262686567164179
Cult of the Lamb,334,89,89,512,0.826171875
Draglade,23,15,8,46,0.8260869565217391
RIVE,58,18,16,92,0.8260869565217391
Sebastien Loeb Rally Evo,119,33,32,184,0.8260869565217391
Star Fox Adventures,135,17,32,184,0.8260869565217391
Deathsmiles,32,6,8,46,0.8260869565217391
Empire Earth III,5,33,8,46,0.8260869565217391
Five Nights at Freddy's,676,136,171,983,0.8260427263479145
New Super Mario Bros. Wii,716,39,159,914,0.8260393873085339
Sly Cooper: Thieves in Time,499,47,115,661,0.8260211800302572
eFootball PES 2021,162,194,75,431,0.8259860788863109
Scarlet Nexus,583,91,142,816,0.8259803921568627
NHL 20,59,126,39,224,0.8258928571428571
Shantae: Risky's Revenge,123,24,31,178,0.8258426966292135
F1 2012,177,41,46,264,0.8257575757575758
DreamWorks Shrek SuperSlam,46,44,19,109,0.8256880733944955
Gravity Rush Remastered,371,41,87,499,0.8256513026052105
Axiom Verge,427,56,102,585,0.8256410256410256
Super Meat Boy,1249,156,297,1702,0.8254994124559342
Call of Duty,1106,53,245,1404,0.8254985754985755
Sid Meier's Civilization III,271,8,59,338,0.8254437869822485
Bastion,2051,138,463,2652,0.8254147812971342
BattleBlock Theater,365,51,88,504,0.8253968253968254
Transformers: Rise of the Dark Spark,95,165,55,315,0.8253968253968254
Capcom Beat 'Em Up Bundle,34,18,11,63,0.8253968253968254
Age of Empires II: HD Edition,499,73,121,693,0.8253968253968254
MotoGP 14,22,30,11,63,0.8253968253968254
Blood of the Werewolf,38,14,11,63,0.8253968253968254
Icewind Dale II,149,7,33,189,0.8253968253968254
The Invincible,78,7,18,103,0.8252427184466019
Panzer Dragoon,90,28,25,143,0.8251748251748252
Oninaki,74,44,25,143,0.8251748251748252
Far Cry 6,1210,1796,637,3643,0.825144111995608
Transformers: Devastation,312,56,78,446,0.8251121076233184
Majin and the Forsaken Kingdom,58,8,14,80,0.825
Oni (2001),86,13,21,120,0.825
The Blackout Club,23,10,7,40,0.825
Atelier Dusk Trilogy Deluxe Pack,25,8,7,40,0.825
APB,23,43,14,80,0.825
Foregone,23,10,7,40,0.825
D4: Dark Dreams Don't Die,250,75,69,394,0.8248730964467005
Death's Door,578,67,137,782,0.8248081841432225
Rune Factory 5,48,32,17,97,0.8247422680412371
Resistance: Retribution,74,6,17,97,0.8247422680412371
Gears of War 4,1406,481,401,2288,0.8247377622377622
Torment: Tides of Numenera,335,140,101,576,0.8246527777777778
Dead Island 2,657,166,175,998,0.8246492985971944
Killer Frequency,41,6,10,57,0.8245614035087719
Wipeout XL,45,2,10,57,0.8245614035087719
Pac-Man World: Re-PAC,38,9,10,57,0.8245614035087719
WWE 2K Battlegrounds,49,92,30,171,0.8245614035087719
Resident Evil: Chronicles HD Collection,36,11,10,57,0.8245614035087719
Project Warlock,73,21,20,114,0.8245614035087719
Heroes of the Storm,838,487,282,1607,0.8245177349097698
Sonic Colors,554,56,130,740,0.8243243243243243
Frozen Synapse,149,34,39,222,0.8243243243243243
Star Wars: Squadrons,425,368,169,962,0.8243243243243243
Okamiden,56,5,13,74,0.8243243243243243
Kinect Sports Rivals,55,67,26,148,0.8243243243243243
Death end re;Quest,46,15,13,74,0.8243243243243243
Arma 3,746,183,198,1127,0.8243123336291038
Rising Storm 2: Vietnam,105,31,29,165,0.8242424242424242
Worms W.M.D,131,33,35,199,0.8241206030150754
Two Worlds,229,99,70,398,0.8241206030150754
Salt and Sacrifice,50,95,31,176,0.8238636363636364
Life is Strange: Before the Storm,1017,137,247,1401,0.8236973590292648
Dead or Alive 4,90,8,21,119,0.8235294117647058
Inazuma Eleven Go: Shadow,23,5,6,34,0.8235294117647058
Monster Hunter,22,6,6,34,0.8235294117647058
Asdivine Hearts,18,10,6,34,0.8235294117647058
Sunless Sea,124,30,33,187,0.8235294117647058
The Wolf Among Us: Episode 4 - In Sheep's Clothing,238,28,57,323,0.8235294117647058
The Eternal Cylinder,23,5,6,34,0.8235294117647058
Bless Unleashed,31,39,15,85,0.8235294117647058
Record of Agarest War,86,40,27,153,0.8235294117647058
Inazuma Eleven 3: Bomb Blast,25,3,6,34,0.8235294117647058
Batman Beyond: Return of the Joker,6,22,6,34,0.8235294117647058
Fear & Hunger,25,3,6,34,0.8235294117647058
Zack & Wiki: Quest for Barbaros' Treasure,50,6,12,68,0.8235294117647058
Mafia III: Stones Unturned,24,4,6,34,0.8235294117647058
Tales of Symphonia Remastered,7,21,6,34,0.8235294117647058
Mayhem Brawler,21,7,6,34,0.8235294117647058
Spore Creature Creator,22,6,6,34,0.8235294117647058
Dance Central 3,37,5,9,51,0.8235294117647058
Sorcerer King,24,18,9,51,0.8235294117647058
American McGee's Alice,159,23,39,221,0.8235294117647058
Naruto Shippuden: Ninja Destiny 2,55,1,12,68,0.8235294117647058
Marvel's Avengers,1140,1798,630,3568,0.8234304932735426
Soul Hackers 2,134,71,44,249,0.8232931726907631
Resistance 3,523,64,126,713,0.82328190743338
Sonic the Hedgehog,209,103,67,379,0.8232189973614775
Orcs Must Die! 2,416,45,99,560,0.8232142857142857
Gran Turismo 5,968,158,242,1368,0.8230994152046783
Let It Die,159,55,46,260,0.823076923076923
Trials HD,100,7,23,130,0.823076923076923
F.E.A.R.,930,28,206,1164,0.8230240549828178
Xenosaga Episode I: Der Wille zur Macht,86,7,20,113,0.8230088495575221
Horizon Chase Turbo,245,34,60,339,0.8230088495575221
Sniper: Ghost Warrior 3,345,185,114,644,0.8229813664596274
Inquisitor,67,12,17,96,0.8229166666666666
Tom Clancy's Splinter Cell: Blacklist,1364,252,348,1964,0.8228105906313645
Concrete Genie,348,42,84,474,0.8227848101265823
Mighty Gunvolt Burst,45,6,11,62,0.8225806451612904
Puyo Puyo Tetris 2,40,11,11,62,0.8225806451612904
Battle Chasers: Nightwar,256,59,68,383,0.8224543080939948
Thomas Was Alone,446,77,113,636,0.8223270440251572
Spelunky,643,176,177,996,0.822289156626506
Dauntless,154,230,83,467,0.8222698072805139
Zombeer,18,19,8,45,0.8222222222222222
Viewtiful Joe 2,31,6,8,45,0.8222222222222222
Valhalla Hills,27,10,8,45,0.8222222222222222
GTFO,49,11,13,73,0.821917808219178
Middle-earth: Shadow of Mordor,4516,625,1114,6255,0.821902478017586
Killzone 3,865,81,205,1151,0.8218940052128584
Deus Ex: Mankind Divided,2218,457,580,3255,0.8218125960061444
Just Dance 2018,42,41,18,101,0.8217821782178217
Rise of the Tomb Raider: 20 Year Celebration,1759,168,418,2345,0.8217484008528785
Biomutant,710,364,233,1307,0.8217291507268554
Skylanders SuperChargers,77,75,33,185,0.8216216216216217
NBA Playgrounds,100,52,33,185,0.8216216216216217
Tom Clancy's Rainbow Six Siege,2299,704,652,3655,0.8216142270861833
Max Payne 3,3677,528,914,5119,0.8214495018558312
Valhalla Knights 3,34,12,10,56,0.8214285714285714
Digimon World 4,29,17,10,56,0.8214285714285714
Frantics,38,31,15,84,0.8214285714285714
The Liar Princess and the Blind Prince,35,11,10,56,0.8214285714285714
Wipeout HD Fury,82,10,20,112,0.8214285714285714
Minecraft Dungeons,535,214,163,912,0.8212719298245614
Lichdom: Battlemage,109,93,44,246,0.8211382113821138
Solar Ash,70,31,22,123,0.8211382113821138
Indiana Jones and the Emperor's Tomb,68,10,17,95,0.8210526315789474
Conduit 2,46,9,12,67,0.8208955223880597
Minecraft: Story Mode - Episode 1: The Order of the Stone,199,231,94,524,0.8206106870229007
The Getaway: Black Monday,30,2,7,39,0.8205128205128205
Aggelos,23,9,7,39,0.8205128205128205
Jump King,25,7,7,39,0.8205128205128205
CreaVures,5,27,7,39,0.8205128205128205
StarCraft 64,24,8,7,39,0.8205128205128205
Star Ocean: First Departure,28,4,7,39,0.8205128205128205
Blitzkrieg 2,25,7,7,39,0.8205128205128205
Call of Duty: Black Ops II - Apocalypse,30,34,14,78,0.8205128205128205
Forgotton Anne,161,31,42,234,0.8205128205128205
Madden NFL 2002,16,16,7,39,0.8205128205128205
Sayonara Wild Hearts,167,25,42,234,0.8205128205128205
Hitman HD Enhanced Collection,10,22,7,39,0.8205128205128205
Werewolf: The Apocalypse - Heart of the Forest,20,12,7,39,0.8205128205128205
Skylanders Swap Force,186,111,65,362,0.8204419889502762
Mount & Blade,231,20,55,306,0.8202614379084967
Paper Mario: Color Splash,295,102,87,484,0.8202479338842975
Red Orchestra 2: Heroes of Stalingrad,491,143,139,773,0.8201811125485123
F1 2018,164,23,41,228,0.8201754385964912
SpellForce 3,126,29,34,189,0.8201058201058201
BUTCHER,31,10,9,50,0.82
Dance Central Spotlight,29,12,9,50,0.82
NHL 2004,31,10,9,50,0.82
SWAT 3: Elite Edition,38,3,9,50,0.82
Scram Kitty and his Buddy on Rails,34,7,9,50,0.82
World of Goo,738,72,178,988,0.819838056680162
Ragnarok Odyssey,77,14,20,111,0.8198198198198198
Syberia,356,26,84,466,0.8197424892703863
S.W.I.N.E.,45,5,11,61,0.819672131147541
Disaster Report 4: Summer Memories,33,17,11,61,0.819672131147541
SWAT 4: The Stetchkov Syndicate,47,3,11,61,0.819672131147541
Just Dance 2017,68,41,24,133,0.8195488721804511
Tony Hawk's Pro Skater 4,253,24,61,338,0.8195266272189349
inFamous: Second Son,3166,310,766,4242,0.8194247996228194
Beat Hazard Ultra,59,9,15,83,0.8192771084337349
The Swapper,701,51,166,918,0.8191721132897604
Lightning Returns: Final Fantasy XIII,571,344,202,1117,0.8191584601611459
Fire Emblem Warriors,333,61,87,481,0.8191268191268192
Tactics Ogre: Reborn,254,63,70,387,0.8191214470284238
Hatred,240,362,133,735,0.819047619047619
NBA 2K14,495,374,192,1061,0.819038642789821
The Witch and the Hundred Knight,78,26,23,127,0.8188976377952756
One Piece Odyssey,67,46,25,138,0.8188405797101449
Diablo III: Reaper of Souls,1007,447,322,1776,0.8186936936936937
Dex,115,34,33,182,0.8186813186813187
Call of Duty: Ghosts,505,76,129,710,0.8183098591549296
Naruto Shippuden: Ultimate Ninja Impact,36,9,10,55,0.8181818181818182
FLY'N,46,8,12,66,0.8181818181818182
Xenon Valkyrie+,20,7,6,33,0.8181818181818182
Bientot l'ete,10,17,6,33,0.8181818181818182
Warlock 2: The Exiled,54,18,16,88,0.8181818181818182
Call of Duty: Advanced Warfare - Havoc,15,12,6,33,0.8181818181818182
Red Wings: Aces of the Sky,20,7,6,33,0.8181818181818182
WarioWare D.I.Y.,33,3,8,44,0.8181818181818182
MTV's Celebrity Deathmatch,12,15,6,33,0.8181818181818182
Lichtspeer,27,9,8,44,0.8181818181818182
Everything,52,29,18,99,0.8181818181818182
Sam & Max: Beyond Time and Space,25,2,6,33,0.8181818181818182
Dead Bits,7,20,6,33,0.8181818181818182
Super Monkey Ball,60,3,14,77,0.8181818181818182
Not For Broadcast,41,4,10,55,0.8181818181818182
Blanc,13,14,6,33,0.8181818181818182
M&M's Beach Party,32,4,8,44,0.8181818181818182
Mega Man Battle Network 6: Cybeast Falzar,18,9,6,33,0.8181818181818182
Monster Hunter Freedom 2,28,8,8,44,0.8181818181818182
Shiness: The Lightning Kingdom,40,14,12,66,0.8181818181818182
Pro Evolution Soccer 2,28,8,8,44,0.8181818181818182
Ixion,22,5,6,33,0.8181818181818182
NBA 2K17,297,188,108,593,0.8178752107925801
Dead Rising 3,604,213,182,999,0.8178178178178178
PixelJunk Monsters,156,37,43,236,0.8177966101694916
The Lord of the Rings: The Return of the King,280,16,66,362,0.8176795580110497
Mario vs. Donkey Kong: Tipping Stars,82,21,23,126,0.8174603174603174
Call of Juarez: Gunslinger,1108,83,266,1457,0.817433081674674
One Piece: Pirate Warriors 3,235,47,63,345,0.8173913043478261
Control,3171,732,872,4775,0.8173821989528796
Prince of Persia Trilogy,59,8,15,82,0.8170731707317073
Tom Clancy's Rainbow Six,61,6,15,82,0.8170731707317073
Battlefield 3: Armored Kill,112,71,41,224,0.8169642857142857
Disney Infinity,139,93,52,284,0.8169014084507042
Driver,150,15,37,202,0.8168316831683168
"Warhammer 40,000: Chaos Gate - Daemonhunters",37,12,11,60,0.8166666666666667
FORGE (2012),120,27,33,180,0.8166666666666667
As Dusk Falls,325,80,91,496,0.8165322580645161
Fallout: New Vegas - Old World Blues,309,38,78,425,0.8164705882352942
The Suffering,118,11,29,158,0.8164556962025317
WRC 9 FIA World Rally Championship,77,52,29,158,0.8164556962025317
Apex Legends,2232,1075,744,4051,0.8163416440385091
JoJo's Bizarre Adventure: All-Star Battle,68,12,18,98,0.8163265306122449
Star Ocean: First Departure R,29,11,9,49,0.8163265306122449
Enlisted,58,62,27,147,0.8163265306122449
Sam & Max: The Devil's Playhouse - Episode 1: The Penal Zone,35,5,9,49,0.8163265306122449
Wartales,36,4,9,49,0.8163265306122449
Madden NFL 18,58,133,43,234,0.8162393162393162
Folklore,97,14,25,136,0.8161764705882353
Company of Heroes 2: Ardennes Assault,46,25,16,87,0.8160919540229885
The Chant,58,13,16,87,0.8160919540229885
Observer: System Redux,106,36,32,174,0.8160919540229885
Heavy Rain Chronicles Episode 1: The Taxidermist,63,8,16,87,0.8160919540229885
Nuclear Throne,225,50,62,337,0.8160237388724035
Kentucky Route Zero - Act I,83,19,23,125,0.816
JUJU,23,8,7,38,0.8157894736842105
Arma: Cold War Assault,29,2,7,38,0.8157894736842105
Baldur's Gate: Tales of the Sword Coast,57,5,14,76,0.8157894736842105
ChromaGun,24,7,7,38,0.8157894736842105
Turbo Overkill,26,5,7,38,0.8157894736842105
Turok 2: Seeds of Evil Remaster,26,5,7,38,0.8157894736842105
Alder's Blood,26,5,7,38,0.8157894736842105
Age of Wonders III,445,68,116,629,0.8155802861685215
Sonic Boom: Fire & Ice,104,33,31,168,0.8154761904761905
Crysis 2 Remastered,50,3,12,65,0.8153846153846154
Evochron Mercenary,42,11,12,65,0.8153846153846154
Faeria,41,12,12,65,0.8153846153846154
Lego Star Wars II: The Original Trilogy,262,25,65,352,0.8153409090909091
Ghost Master (2003),66,9,17,92,0.8152173913043478
EA Sports PGA Tour,48,27,17,92,0.8152173913043478
The Sexy Brutale,139,33,39,211,0.8151658767772512
Crypt of the NecroDancer,277,67,78,422,0.8151658767772512
Project IGI: I'm Going In,82,15,22,119,0.8151260504201681
Assassin's Creed Odyssey,4204,2042,1417,7663,0.8150854756622733
NBA Live 16,67,52,27,146,0.815068493150685
Assassin's Creed Unity,4497,2826,1664,8987,0.8148436630688772
Crucible,11,33,10,54,0.8148148148148148
Harvest Moon 3D: The Lost Valley,12,32,10,54,0.8148148148148148
Irony Curtain: From Matryoshka with Love,35,9,10,54,0.8148148148148148
Shadowrun Chronicles: Boston Lockdown,32,12,10,54,0.8148148148148148
Forza Horizon 4: Fortune Island,36,8,10,54,0.8148148148148148
Expeditions: Rome,59,7,15,81,0.8148148148148148
Just Dance,30,14,10,54,0.8148148148148148
Destiny: House of Wolves,91,186,63,340,0.8147058823529412
American Truck Simulator,215,53,61,329,0.8145896656534954
New Super Mario Bros. U,740,72,185,997,0.8144433299899699
Age of Wonders 4,71,8,18,97,0.8144329896907216
State of Decay 2,604,558,265,1427,0.8142957252978276
Dark Cloud,100,14,26,140,0.8142857142857143
Homefront: The Revolution,330,463,181,974,0.8141683778234087
Star Fox: Assault,87,5,21,113,0.8141592920353983
Mafia II,2845,212,698,3755,0.8141145139813581
Life is Strange 2,661,359,233,1253,0.8140462889066241
Shogun: Total War,97,8,24,129,0.813953488372093
A Space For The Unbound,56,14,16,86,0.813953488372093
Age of Empires: Mythologies,31,4,8,43,0.813953488372093
Star Wars Galaxies: An Empire Divided,22,13,8,43,0.813953488372093
Danganronpa Another Episode: Ultra Despair Girls,167,34,46,247,0.8137651821862348
Wasteland 2: Director's Cut,380,83,106,569,0.8137082601054482
Defiance,594,266,197,1057,0.8136234626300851
Postal 2: Paradise Lost,41,7,11,59,0.8135593220338984
GORN,33,15,11,59,0.8135593220338984
Super Mario Advance,90,6,22,118,0.8135593220338984
The Blackwell Deception,42,6,11,59,0.8135593220338984
Gas Guzzlers: Combat Carnage,39,9,11,59,0.8135593220338984
Gurumin: A Monstrous Adventure,44,4,11,59,0.8135593220338984
Armored Core: Verdict Day,38,10,11,59,0.8135593220338984
Halo: Combat Evolved Anniversary,591,72,152,815,0.8134969325153374
Ultra Street Fighter IV,273,89,83,445,0.8134831460674158
Destiny 2,1722,2486,965,5173,0.8134544751594819
Football Manager 2014,135,109,56,300,0.8133333333333334
Rez,60,1,14,75,0.8133333333333334
BioShock 2,2554,134,617,3305,0.8133131618759455
The Sims 3: Generations,23,51,17,91,0.8131868131868132
Valdis Story: Abyssal City,63,11,17,91,0.8131868131868132
Forza Motorsport 5,586,367,219,1172,0.8131399317406144
Batman: The Enemy Within - Episode 1: The Enigma,57,30,20,107,0.8130841121495327
Gabriel Knight: Sins of the Fathers 20th Anniversary Edition,75,12,20,107,0.8130841121495327
Naruto Shippuden: Ultimate Ninja Storm Trilogy,84,16,23,123,0.8130081300813008
Vindictus,81,32,26,139,0.8129496402877698
Timespinner,76,37,26,139,0.8129496402877698
Gothic 3: Forsaken Gods,20,119,32,171,0.8128654970760234
F1 2010,201,42,56,299,0.8127090301003345
Painkiller,247,9,59,315,0.8126984126984127
Mortal Kombat XL,633,87,166,886,0.8126410835214447
Killzone 2,682,90,178,950,0.8126315789473684
Game of Thrones: Episode One - Iron From Ice,392,98,113,603,0.8126036484245439
Sam & Max: The Devil's Playhouse - Episode 5: The City That Dares Not Sleep,23,3,6,32,0.8125
Batman: Arkham Asylum - Game of the Year Edition,36,3,9,48,0.8125
Harvest Moon: Magical Melody,22,4,6,32,0.8125
NHL Legacy Edition,14,12,6,32,0.8125
Mystical Ninja starring Goemon,37,2,9,48,0.8125
Final Fantasy IV Pixel Remaster,19,7,6,32,0.8125
Aliens vs. Predator: Requiem,56,9,15,80,0.8125
Raiders of the Broken Planet,26,26,12,64,0.8125
Super Monkey Ball 2,60,5,15,80,0.8125
Star Trek: Resurgence,38,14,12,64,0.8125
Caveblazers,22,4,6,32,0.8125
Resident Evil: Revelations 2 - Extra Episode 1: The Struggle,18,8,6,32,0.8125
Fallout 4: Vault-Tec Workshop,24,67,21,112,0.8125
Hyperdimension Neptunia U: Action Unleashed,37,15,12,64,0.8125
Gujian3,21,5,6,32,0.8125
Totally Reliable Delivery Service,21,31,12,64,0.8125
Daytona USA (2011),30,9,9,48,0.8125
SpongeBob Squarepants: The Yellow Avenger,13,13,6,32,0.8125
Bleed 2,31,8,9,48,0.8125
Ray Gigant,22,4,6,32,0.8125
Breath of Fire,20,6,6,32,0.8125
PC Building Simulator 2,15,11,6,32,0.8125
Little Witch Nobeta,19,7,6,32,0.8125
Driveclub,951,517,339,1807,0.8123962368566685
The Outer Worlds,3170,694,893,4757,0.8122766449442926
Homeworld: Deserts of Kharak,167,23,44,234,0.811965811965812
ROBLOX,119,153,63,335,0.8119402985074626
Batman: Arkham VR,141,36,41,218,0.8119266055045872
Tormentum - Dark Sorrow,70,12,19,101,0.8118811881188119
Football Manager 2013,162,58,51,271,0.8118081180811808
Alan Wake,2478,213,624,3315,0.8117647058823529
Chicory: A Colorful Tale,108,30,32,170,0.8117647058823529
The Touryst,94,18,26,138,0.8115942028985508
The Outer Worlds: Murder on Eridanos,38,18,13,69,0.8115942028985508
Fight Night Champion,178,33,49,260,0.8115384615384615
DREDGE,180,18,46,244,0.8114754098360656
Might & Magic: Clash of Heroes,152,33,43,228,0.8114035087719298
Call of Duty: Black Ops II - Uprising,41,45,20,106,0.8113207547169812
TOEM,68,18,20,106,0.8113207547169812
Need for Speed: Hot Pursuit Remastered,185,116,70,371,0.8113207547169812
Alien Hominid,34,9,10,53,0.8113207547169812
Disciples III: Reincarnation,38,5,10,53,0.8113207547169812
RIDE 4,52,34,20,106,0.8113207547169812
Dragon's Lair,24,19,10,53,0.8113207547169812
Yu-Gi-Oh! Forbidden Memories,81,5,20,106,0.8113207547169812
Star Ocean: The Last Hope,128,31,37,196,0.8112244897959183
Deliver Us Mars,40,33,17,90,0.8111111111111111
APB: Reloaded,137,155,68,360,0.8111111111111111
Madden NFL 2004,47,26,17,90,0.8111111111111111
Wonder Boy: The Dragon's Trap,205,31,55,291,0.8109965635738832
The Surge 2,258,111,86,455,0.810989010989011
Hob,151,42,45,238,0.8109243697478992
World in Conflict,210,13,52,275,0.8109090909090909
Darksiders: Warmastered Edition,435,41,111,587,0.8109028960817717
F-Zero: Maximum Velocity,26,4,7,37,0.8108108108108109
Nippon Marathon,21,9,7,37,0.8108108108108109
Blazing Beaks,27,3,7,37,0.8108108108108109
Tom Clancy's The Division - Underground,38,22,14,74,0.8108108108108109
The Settlers III,27,3,7,37,0.8108108108108109
Evoland: Legendary Edition,24,6,7,37,0.8108108108108109
Airborne Kingdom,24,6,7,37,0.8108108108108109
Fort Triumph,26,4,7,37,0.8108108108108109
Mass Effect 3: Rebellion Pack,19,11,7,37,0.8108108108108109
Eador: Masters of the Broken World,135,45,42,222,0.8108108108108109
ARK: Survival Evolved,598,452,245,1295,0.8108108108108109
Touhou Genso Rondo: Bullet Ballet,16,14,7,37,0.8108108108108109
We Are OFK,7,23,7,37,0.8108108108108109
FIFA 16,625,1072,396,2093,0.8107978977544195
Dragon Ball: Xenoverse,780,197,228,1205,0.8107883817427386
Gotham Knights,395,582,228,1205,0.8107883817427386
Alice: Madness Returns,986,63,245,1294,0.8106646058732612
Warriors Orochi 3,67,10,18,95,0.8105263157894737
Soldier of Fortune,73,4,18,95,0.8105263157894737
Omega Quintet,58,19,18,95,0.8105263157894737
WWE 2K16,273,129,94,496,0.8104838709677419
L.A. Noire: The Complete Edition,1093,104,280,1477,0.8104265402843602
FIFA 18,525,1206,405,2136,0.8103932584269663
Sherlock Holmes: The Silver Earring,31,16,11,58,0.8103448275862069
Charlie Murder,36,11,11,58,0.8103448275862069
The Witcher Adventure Game,56,38,22,116,0.8103448275862069
Fury Unleashed,34,13,11,58,0.8103448275862069
Sang-Froid: Tales of Werewolves,80,14,22,116,0.8103448275862069
Sins of a Solar Empire: Rebellion,206,29,55,290,0.8103448275862069
NHL 12,91,20,26,137,0.8102189781021898
Diddy Kong Racing,171,4,41,216,0.8101851851851852
Aliens: Colonial Marines,376,1297,392,2065,0.8101694915254237
Call of Duty: Black Ops III,1931,2725,1091,5747,0.8101618235601183
Super Lucky's Tale,144,48,45,237,0.810126582278481
Super Mario Strikers,80,1,19,100,0.81
Tropico,91,7,23,121,0.8099173553719008
Counter-Strike: Source,1002,88,256,1346,0.8098068350668648
Obduction,118,31,35,184,0.8097826086956522
DiRT Rally 2.0,215,134,82,431,0.8097447795823666
Star Wars: The Old Republic,1390,959,552,2901,0.8097207859358841
Ratchet & Clank: Into the Nexus,258,27,67,352,0.8096590909090909
Prison Architect,269,33,71,373,0.8096514745308311
Hotline Miami 2: Wrong Number,792,131,217,1140,0.8096491228070175
Monster Energy Supercross - The Official Videogame 5,7,27,8,42,0.8095238095238095
Batman: The Brave and the Bold - The Videogame,31,3,8,42,0.8095238095238095
The House of the Dead: Overkill - Extended Cut,30,4,8,42,0.8095238095238095
Tetrobot and Co.,29,5,8,42,0.8095238095238095
ARK: Survival Ascended,13,21,8,42,0.8095238095238095
Blue Reflection,53,15,16,84,0.8095238095238095
Apollo Justice: Ace Attorney,113,23,32,168,0.8095238095238095
Oddworld: Abe's Oddysee - New 'n' Tasty,490,79,134,703,0.8093883357041252
Dragon Quest Heroes: The World Tree's Woe and the Blight Below,196,46,57,299,0.8093645484949833
Halo 4,2490,794,774,4058,0.8092656481025136
FAR: Lone Sails,200,33,55,288,0.8090277777777778
The Long Dark,368,153,123,644,0.8090062111801242
Day of the Tentacle Remastered,245,43,68,356,0.8089887640449438
Indivisible,141,58,47,246,0.8089430894308943
Lethal League,46,9,13,68,0.8088235294117647
Steven Universe: Save the Light,44,11,13,68,0.8088235294117647
Fallout 4,9176,5643,3503,18322,0.80880908197795
Castlevania: Portrait of Ruin,90,3,22,115,0.808695652173913
Farming Simulator 2013,94,37,31,162,0.808641975308642
Barony (2015),30,8,9,47,0.8085106382978723
Westerado: Double Barreled,31,7,9,47,0.8085106382978723
Rock of Ages 3: Make & Break,21,17,9,47,0.8085106382978723
Rise of Nightmares,33,5,9,47,0.8085106382978723
Rory McIlroy PGA Tour,34,101,32,167,0.8083832335329342
Senran Kagura Burst,44,15,14,73,0.8082191780821918
Romance of the Three Kingdoms XIII,46,13,14,73,0.8082191780821918
Age of Empires: The Rise of Rome,45,14,14,73,0.8082191780821918
Song of Horror,47,12,14,73,0.8082191780821918
Earth Defense Force: Iron Rain,22,20,10,52,0.8076923076923077
ShootMania Storm,49,14,15,78,0.8076923076923077
Minecraft: Story Mode - Episode 2: Assembly Required,64,83,35,182,0.8076923076923077
Steel Rats,34,8,10,52,0.8076923076923077
Bramble: The Mountain King,150,22,41,213,0.8075117370892019
Skulls of the Shogun,115,36,36,187,0.8074866310160428
Guacamelee! Super Turbo Championship Edition,676,125,191,992,0.8074596774193549
Assassin's Creed Origins,4462,1199,1350,7011,0.8074454428754814
F1 2021,127,112,57,296,0.8074324324324325
Tearaway Unfolded,233,31,63,327,0.8073394495412844
The King of Fighters XIII Climax,61,6,16,83,0.8072289156626506
Cities: Skylines - After Dark,59,8,16,83,0.8072289156626506
The Bard's Tale IV: Director's Cut,45,22,16,83,0.8072289156626506
MORDHAU,183,43,54,280,0.8071428571428572
Karaoke Revolution Party,238,59,71,368,0.8070652173913043
Europa Universalis IV: Conquest of Paradise,39,7,11,57,0.8070175438596491
Half-Minute Hero,43,3,11,57,0.8070175438596491
Might & Magic X: Legacy,217,59,66,342,0.8070175438596491
Infliction: Extended Cut,18,28,11,57,0.8070175438596491
Killer Is Dead,326,88,99,513,0.8070175438596491
Partisans 1941,36,10,11,57,0.8070175438596491
Under Night In-Birth Exe:Late[cl-r],35,11,11,57,0.8070175438596491
Madden NFL 08,103,14,28,145,0.8068965517241379
RIDE,54,42,23,119,0.8067226890756303
POSTAL 4: No Regerts,174,18,46,238,0.8067226890756303
Neverwinter Nights,483,30,123,636,0.8066037735849056
Jump Force,168,324,118,610,0.8065573770491803
NBA 2K16,390,202,142,734,0.8065395095367848
Hate Plus: ~Mutes Golden Days~,17,8,6,31,0.8064516129032258
Cubemen 2,19,6,6,31,0.8064516129032258
rFactor 2,19,6,6,31,0.8064516129032258
Shiftlings,14,11,6,31,0.8064516129032258
Train Fever,56,19,18,93,0.8064516129032258
Super Neptunia RPG,21,29,12,62,0.8064516129032258
VirtuaVerse,21,4,6,31,0.8064516129032258
DogFighter,20,5,6,31,0.8064516129032258
Yu-Gi-Oh! Capsule Monster Coliseum,24,1,6,31,0.8064516129032258
Block N Load,20,5,6,31,0.8064516129032258
Emily Wants To Play,17,8,6,31,0.8064516129032258
Roguebook,15,10,6,31,0.8064516129032258
My Name is Mayo,35,40,18,93,0.8064516129032258
Guilty Gear X2,23,2,6,31,0.8064516129032258
The Bard's Tale: Remastered and Resnarkled,19,6,6,31,0.8064516129032258
Layers of Fear,27,23,12,62,0.8064516129032258
Downfall (2009),24,1,6,31,0.8064516129032258
NBA 2K12,241,63,73,377,0.8063660477453581
Fat Princess,87,17,25,129,0.8062015503875969
Daymare: 1998,186,76,63,325,0.8061538461538461
Grand Theft Auto Online,276,327,145,748,0.8061497326203209
The Dungeon of Naheulbeuk: The Amulet of Chaos,65,14,19,98,0.8061224489795918
Fallout 4: Far Harbor,343,139,116,598,0.8060200668896321
The Banner Saga,826,100,223,1149,0.8059181897302001
Dark Souls II: Scholar of the First Sin,2000,346,565,2911,0.8059086224665064
Michael Jackson The Experience,113,24,33,170,0.8058823529411765
Destroy All Humans!,263,44,74,381,0.8057742782152231
Romancing SaGa,25,4,7,36,0.8055555555555556
Mass Effect 3: Reckoning,20,9,7,36,0.8055555555555556
Children of Zodiarcs,18,11,7,36,0.8055555555555556
Dead or Alive 5 Ultimate,77,10,21,108,0.8055555555555556
Kingdom Two Crowns,70,17,21,108,0.8055555555555556
One Finger Death Punch 2,23,6,7,36,0.8055555555555556
Naruto x Boruto: Ultimate Ninja Storm Connections,33,54,21,108,0.8055555555555556
Patapon 3,46,12,14,72,0.8055555555555556
BioShock 2: Sinclair Solutions Test Pack,26,3,7,36,0.8055555555555556
WRC: FIA World Rally Championship (2006),18,11,7,36,0.8055555555555556
Def Jam Vendetta,26,3,7,36,0.8055555555555556
Dead Rising 3: Fallen Angel,13,16,7,36,0.8055555555555556
Kill la Kill: IF,57,30,21,108,0.8055555555555556
Kingpin: Life of Crime,26,3,7,36,0.8055555555555556
JASF: Jane's Advanced Strike Fighters,10,19,7,36,0.8055555555555556
Earth Defense Force 2017,55,32,21,108,0.8055555555555556
Downwell,219,71,70,360,0.8055555555555556
Riddled Corpses EX,24,5,7,36,0.8055555555555556
Long Live The Queen,104,16,29,149,0.8053691275167785
Orcs Must Die!,455,25,116,596,0.8053691275167785
Call of Cthulhu: Dark Corners of the Earth,154,28,44,226,0.8053097345132744
Metro 2033,1616,154,428,2198,0.805277525022748
inFamous,973,40,245,1258,0.8052464228934817
PowerWash Simulator,76,48,30,154,0.8051948051948052
Mario Party 3,93,2,23,118,0.8050847457627118
Watch Dogs 2,2511,498,729,3738,0.804975922953451
Jagged Alliance: Rage!,6,27,8,41,0.8048780487804879
Mundaun,25,8,8,41,0.8048780487804879
Flight Simulator 2002,26,7,8,41,0.8048780487804879
Transformice,27,6,8,41,0.8048780487804879
Tethered,29,4,8,41,0.8048780487804879
Gods Eater Burst,30,3,8,41,0.8048780487804879
Tales of Eternia,31,2,8,41,0.8048780487804879
Battlefleet Gothic: Armada,85,18,25,128,0.8046875
The Falconeer,49,54,25,128,0.8046875
Hot Wheels Unleashed,137,36,42,215,0.8046511627906977
Counter-Strike: Global Offensive,3556,1016,1110,5682,0.8046462513199577
The Callisto Protocol,1382,565,473,2420,0.8045454545454546
NHL 19,79,69,36,184,0.8043478260869565
Shad'O,25,12,9,46,0.8043478260869565
Destroy All Humans! 2,66,8,18,92,0.8043478260869565
Silent Hunter 5: Battle of the Atlantic,18,19,9,46,0.8043478260869565
Sonic Mega Collection (2002),35,2,9,46,0.8043478260869565
Battle Arena Toshinden,33,4,9,46,0.8043478260869565
Hydro Thunder Hurricane,34,3,9,46,0.8043478260869565
Ultimate NES Remix,28,9,9,46,0.8043478260869565
Alfred Hitchcock: Vertigo,33,4,9,46,0.8043478260869565
Wreckfest,445,114,136,695,0.8043165467625899
Madden NFL 16,168,132,73,373,0.8042895442359249
Deadfall Adventures,175,55,56,286,0.8041958041958042
Transformers: War for Cybertron,262,46,75,383,0.804177545691906
AMID EVIL,64,14,19,97,0.8041237113402062
Darksiders II: Deathinitive Edition,420,56,116,592,0.8040540540540541
Immortals of Aveum,79,85,40,204,0.803921568627451
Giana Sisters: Twisted Dreams,171,34,50,255,0.803921568627451
BAD END THEATER,38,3,10,51,0.803921568627451
EA Sports MMA,66,16,20,102,0.803921568627451
Mega Man Legends,31,10,10,51,0.803921568627451
Call of Duty: Black Ops II,2684,2386,1238,6308,0.8037412809131262
Evil Genius,81,5,21,107,0.8037383177570093
Pokemon Mystery Dungeon: Red Rescue Team,118,13,32,163,0.803680981595092
Earth Atlantis,35,10,11,56,0.8035714285714286
Blinx: The Time Sweeper,38,7,11,56,0.8035714285714286
BioShock 2: Protector Trials,37,8,11,56,0.8035714285714286
Penny Arcade Adventures: Episode Three,36,9,11,56,0.8035714285714286
The Magic Circle,37,8,11,56,0.8035714285714286
Colin McRae Rally 04,43,2,11,56,0.8035714285714286
Heroes & Generals,68,71,34,173,0.8034682080924855
Lineage II,70,24,23,117,0.8034188034188035
Rainbow Moon,68,26,23,117,0.8034188034188035
The Pinball Arcade,104,39,35,178,0.8033707865168539
LIMBO,2844,216,749,3809,0.8033604620635337
Child of Eden,87,11,24,122,0.8032786885245902
Woah Dave!,26,23,12,61,0.8032786885245902
Minecraft: Story Mode - Episode 8: A Journey's End?,39,10,12,61,0.8032786885245902
Predator: Concrete Jungle,45,4,12,61,0.8032786885245902
Angry Birds Trilogy,45,53,24,122,0.8032786885245902
Fist of the North Star: Lost Paradise,82,20,25,127,0.8031496062992126
StarDrive (2012),221,89,76,386,0.8031088082901554
The Elder Scrolls: Legends,51,55,26,132,0.803030303030303
Animal Crossing: Wild World,149,10,39,198,0.803030303030303
Call of Duty: Black Ops Declassified,187,241,105,533,0.8030018761726079
Sundered,90,24,28,142,0.8028169014084507
Tales of Zestiria,396,117,126,639,0.8028169014084507
Little Nightmares,1061,78,280,1419,0.802677942212826
Cradle,47,14,15,76,0.8026315789473685
Galak-Z: The Dimensional,93,29,30,152,0.8026315789473685
Darksiders III,914,273,292,1479,0.8025693035835023
Pokemon XD: Gale of Darkness,116,10,31,157,0.802547770700637
Divinity II: Developer's Cut,56,9,16,81,0.8024691358024691
Dynasty Warriors 4,50,15,16,81,0.8024691358024691
Wolcen: Lords of Mayhem,202,188,96,486,0.8024691358024691
Batman: The Telltale Series - Episode 1: Realm of Shadows,220,109,81,410,0.802439024390244
One Piece: Pirate Warriors 4,177,22,49,248,0.8024193548387096
Might & Magic: Heroes VI - Shades of Darkness,35,34,17,86,0.8023255813953488
MotorStorm: Pacific Rift,128,10,34,172,0.8023255813953488
Dynasty Warriors: Godseekers,132,10,35,177,0.8022598870056498
The Inner World,55,18,18,91,0.8021978021978022
Senran Kagura: Peach Beach Splash,57,20,19,96,0.8020833333333334
Nickelodeon Kart Racers,39,38,19,96,0.8020833333333334
Need for Speed,1331,610,479,2420,0.8020661157024793
Overcooked! All You Can Eat,58,23,20,101,0.801980198019802
Lords of the Fallen,637,282,227,1146,0.8019197207678883
Prince of Persia: The Two Thrones,511,35,135,681,0.801762114537445
Trine 4: The Nightmare Prince,160,22,45,227,0.801762114537445
VVVVVV,351,57,101,509,0.8015717092337917
LEGO The Lord of the Rings,383,61,110,554,0.8014440433212996
Scaler,208,18,56,282,0.8014184397163121
Men of War: Assault Squad 2,78,39,29,146,0.8013698630136986
SpongeBob SquarePants: The Cosmic Shake,94,23,29,146,0.8013698630136986
Ken Follett's The Pillars of the Earth,111,14,31,156,0.8012820512820513
Saints Row: The Third,2019,189,548,2756,0.8011611030478955
Slime Rancher,257,29,71,357,0.8011204481792717
World War Z,541,353,222,1116,0.8010752688172043
Just Dance 2014 (French),136,57,48,241,0.8008298755186722
Graveyard Keeper,146,55,50,251,0.8007968127490039
Baldur's Gate: Enhanced Edition,284,130,103,517,0.8007736943907157
Midnight Club: Los Angeles,191,22,53,266,0.8007518796992481
Sword Coast Legends,114,107,55,276,0.8007246376811594
Ultimate Spider-Man,234,11,61,306,0.8006535947712419
Titanfall,2581,1245,954,4780,0.800418410041841
Conan Exiles,233,188,105,526,0.8003802281368821
Postal 2,515,54,142,711,0.8002812939521801
Super Monkey Ball Deluxe,159,41,50,250,0.8
Grandia III,38,6,11,55,0.8
Earth Defense Force: Insect Armageddon,71,17,22,110,0.8
Advent Rising,59,9,17,85,0.8
Football Manager 2017,59,49,27,135,0.8
Pirates of the Caribbean,35,5,10,50,0.8
Morphite,19,5,6,30,0.8
Gear.Club Unlimited,40,16,14,70,0.8
Lucius II,7,45,13,65,0.8
NaissanceE,37,11,12,60,0.8
Rogue Stormers,18,6,6,30,0.8
Bravo Team,20,28,12,60,0.8
Super Street: The Game,24,16,10,50,0.8
Mutant Year Zero: Road to Eden - Deluxe Edition,11,13,6,30,0.8
South Park: The Fractured But Whole - From Dusk till Casa Bonita,19,9,7,35,0.8
The Council - Episode 3: Ripples,22,6,7,35,0.8
WRC Generations,29,7,9,45,0.8
Lord of Arcana,22,6,7,35,0.8
Shadows of the Damned,260,24,71,355,0.8
WarioWare: Twisted!,27,1,7,35,0.8
Arizona Sunshine,59,21,20,100,0.8
Syndrome,9,15,6,30,0.8
The Sims 4: Dine Out,16,8,6,30,0.8
Valkyrie Drive: Bhikkhuni,20,4,6,30,0.8
Worms 2,22,2,6,30,0.8
Lost Sphear,90,34,31,155,0.8
Blazing Chrome,88,16,26,130,0.8
Souldiers,25,19,11,55,0.8
Game Builder Garage,34,6,10,50,0.8
Sins of a Solar Empire,128,8,34,170,0.8
Immortal Cities: Children of the Nile,19,5,6,30,0.8
No More Heroes: Heroes Paradise,33,7,10,50,0.8
"Warhammer 40,000: Squad Command",27,1,7,35,0.8
Tiger Woods PGA Tour 14,24,20,11,55,0.8
Mario Sports Superstars,31,9,10,50,0.8
Astro Bears Party,25,7,8,40,0.8
Onigiri,18,10,7,35,0.8
Lost Dimension,55,9,16,80,0.8
Castle of Heart,35,13,12,60,0.8
The Hex,23,1,6,30,0.8
Shady Part of Me,28,8,9,45,0.8
The Legend of Tianding,29,7,9,45,0.8
Impostor Factory,36,4,10,50,0.8
Naruto: Ultimate Ninja 3,47,1,12,60,0.8
X-Men: The Arcade Game,22,6,7,35,0.8
Duke Nukem: Critical Mass,6,18,6,30,0.8
Jagged Alliance: Crossfire,11,21,8,40,0.8
Silent Hunter: Wolves of the Pacific,20,4,6,30,0.8
Battlefield 3: Close Quarters,127,57,46,230,0.8
Quiplash,30,6,9,45,0.8
Castlevania: Harmony of Dissonance,84,4,22,110,0.8
Teenage Mutant Ninja Turtles: Mutants in Manhattan,135,133,67,335,0.8
Hack 'n' Slash,15,17,8,40,0.8
Destiny of Spirits,24,8,8,40,0.8
NES Remix 2,43,5,12,60,0.8
AirMech Arena,42,18,15,75,0.8
Tom & Jerry in War of the Whiskers,18,6,6,30,0.8
Kalimba,25,7,8,40,0.8
Croc: Legend of the Gobbos,34,6,10,50,0.8
Shogo: Mobile Armor Division,61,3,16,80,0.8
Way of the Hunter,21,11,8,40,0.8
Heroes of Might and Magic V,400,31,108,539,0.7996289424860853
Grand Theft Auto: Chinatown Wars,361,70,108,539,0.7996289424860853
Gone Home,1131,1174,578,2883,0.7995143947277142
Sonic the Hedgehog (2006),400,528,233,1161,0.7993109388458226
Castle Crashers,518,35,139,692,0.7991329479768786
Minecraft: Story Mode - A Telltale Games Series,84,83,42,209,0.7990430622009569
South Park: The Fractured But Whole,913,160,270,1343,0.7989575577066269
Game of Thrones: Episode Four - Sons of Winter,115,28,36,179,0.7988826815642458
Forza Horizon 2 Presents Fast & Furious,115,28,36,179,0.7988826815642458
Fire Emblem Engage,485,226,179,890,0.798876404494382
ZEN Pinball 2,105,30,34,169,0.7988165680473372
Wargroove,192,78,68,338,0.7988165680473372
Chibi-Robo! Zip Lash,50,57,27,134,0.7985074626865671
Loop8: Summer of Gods,98,1,25,124,0.7983870967741935
Nether,40,59,25,124,0.7983870967741935
Call of Duty: Modern Warfare 2,3778,921,1187,5886,0.7983350322799864
Tom Clancy's The Division,2711,1192,986,4889,0.7983227653916957
Rome: Total War Barbarian Invasion,93,2,24,119,0.7983193277310925
Unravel,672,76,189,937,0.7982924226254002
Stranger Things 3: The Game,71,20,23,114,0.7982456140350878
F.I.S.T.: Forged In Shadow Torch,145,33,45,223,0.7982062780269058
Cosmic Star Heroine,71,16,22,109,0.7981651376146789
Kinect: Disneyland Adventures,28,59,22,109,0.7981651376146789
Rise of Nations: Rise of Legends,74,5,20,99,0.797979797979798
Project Spark,100,50,38,188,0.7978723404255319
Age of Wonders: Planetfall,108,38,37,183,0.7978142076502732
Life is Strange: True Colors,617,243,218,1078,0.7977736549165121
Battlefield: Bad Company 2 Vietnam,307,32,86,425,0.7976470588235294
Mad Max,2589,312,736,3637,0.7976354138025845
Livelock,50,17,17,84,0.7976190476190477
Just Dance 2016,42,25,17,84,0.7976190476190477
Battlefield Heroes,91,35,32,158,0.7974683544303798
LittleBigPlanet,1118,102,310,1530,0.7973856209150327
The Book of Unwritten Tales 2,104,18,31,153,0.7973856209150327
Resident Evil: Revelations 2,1128,186,334,1648,0.7973300970873787
Deponia Doomsday,94,20,29,143,0.7972027972027972
Agents of Mayhem,176,107,72,355,0.7971830985915493
Shaq Fu: A Legend Reborn,65,45,28,138,0.7971014492753623
Asterigos: Curse of the Stars,65,45,28,138,0.7971014492753623
Plants vs. Zombies: Battle for Neighborville,193,180,95,468,0.7970085470085471
The Quarry,525,244,196,965,0.7968911917098446
Detention,136,17,39,192,0.796875
Dyad (2012),32,19,13,64,0.796875
The Banner Saga 3,173,27,51,251,0.796812749003984
Super Paper Mario,396,35,110,541,0.7966728280961183
Guacamelee! Gold Edition,201,34,60,295,0.7966101694915254
Dynasty Warriors 3,40,7,12,59,0.7966101694915254
Call of Duty: Ghosts - Onslaught,19,28,12,59,0.7966101694915254
Iconoclasts,199,36,60,295,0.7966101694915254
Hardspace: Shipbreaker,38,9,12,59,0.7966101694915254
WWE SmackDown! vs. Raw 2006,85,5,23,113,0.7964601769911505
F1 22,65,154,56,275,0.7963636363636364
MechWarrior Online,323,373,178,874,0.7963386727688787
Kentucky Route Zero - Act IV,25,18,11,54,0.7962962962962963
Shadow Warrior (1997),42,1,11,54,0.7962962962962963
Gods Will Fall,16,27,11,54,0.7962962962962963
Pac-Man 256,62,20,21,103,0.7961165048543689
Tell Me Why,264,228,126,618,0.7961165048543689
Mafia: Definitive Edition,1932,654,663,3249,0.7959372114496768
RWBY: Grimm Eclipse,23,16,10,49,0.7959183673469388
Back 4 Blood,365,376,190,931,0.7959183673469388
"Warhammer 40,000: Dawn of War - Winter Assault",114,3,30,147,0.7959183673469388
The Dark Eye: Chains of Satinav,102,15,30,147,0.7959183673469388
Gunfire Reborn,31,8,10,49,0.7959183673469388
Sleeping Dogs: Definitive Edition,724,75,205,1004,0.795816733067729
The Matrix: Path of Neo,98,54,39,191,0.7958115183246073
SIREN: Blood Curse,64,10,19,93,0.7956989247311828
Battalion Wars 2,34,1,9,44,0.7954545454545454
Nickelodeon All-Star Brawl,84,52,35,171,0.7953216374269005
Empire of Sin,74,62,35,171,0.7953216374269005
Sunless Skies,48,18,17,83,0.7951807228915663
Silent Hill: Shattered Memories,267,63,85,415,0.7951807228915663
Tharsis,32,34,17,83,0.7951807228915663
Halo 5: Guardians,1961,1030,771,3762,0.7950558213716108
Hellpoint,83,45,33,161,0.7950310559006211
Game of Thrones: Episode Two - The Lost Lords,187,34,57,278,0.7949640287769785
BlazBlue: Continuum Shift II,23,8,8,39,0.7948717948717948
The Dishwasher: Vampire Smile,28,3,8,39,0.7948717948717948
A Game of Thrones: Genesis,25,68,24,117,0.7948717948717948
Darkstone,28,3,8,39,0.7948717948717948
Regalia: Of Men and Monarchs,27,4,8,39,0.7948717948717948
WWE 2K19,137,76,55,268,0.7947761194029851
Amnesia Collection,99,21,31,151,0.7947019867549668
The Technomancer,252,104,92,448,0.7946428571428571
DOOM 64,156,22,46,224,0.7946428571428571
Septerra Core: Legacy of the Creator,48,10,15,73,0.7945205479452054
Enslaved: Odyssey to the West,730,97,214,1041,0.7944284341978867
Human Resource Machine,73,12,22,107,0.794392523364486
Farming Simulator 17,88,24,29,141,0.7943262411347518
Warface,215,372,152,739,0.7943166441136671
Cossacks 3,112,54,43,209,0.7942583732057417
Super Princess Peach,51,3,14,68,0.7941176470588235
Donkey Kong Jungle Beat,53,1,14,68,0.7941176470588235
Aaero,17,10,7,34,0.7941176470588235
100% Orange Juice,22,5,7,34,0.7941176470588235
Dead Head Fred,25,2,7,34,0.7941176470588235
Doorways (2013),15,12,7,34,0.7941176470588235
Master of Orion: Conquer the Stars,102,33,35,170,0.7941176470588235
Tennis in the Face,15,12,7,34,0.7941176470588235
Flame Over,14,13,7,34,0.7941176470588235
Bombing Busters,3,24,7,34,0.7941176470588235
Peggle Nights (2008),22,5,7,34,0.7941176470588235
Fortune Street,22,5,7,34,0.7941176470588235
Castlevania,26,1,7,34,0.7941176470588235
Rise of the Triad,126,63,49,238,0.7941176470588235
Raiden V,20,7,7,34,0.7941176470588235
Evoland 2: A Slight Case of Spacetime Continuum Disorder,43,11,14,68,0.7941176470588235
The Crew,691,543,320,1554,0.7940797940797941
Manhunt,293,27,83,403,0.794044665012407
State of Decay: Year One Survival Edition,144,95,62,301,0.7940199335548173
NHL 15,102,376,124,602,0.7940199335548173
Alienation,162,23,48,233,0.7939914163090128
Metal Gear Solid V: Metal Gear Online,75,29,27,131,0.7938931297709924
War for the Overworld,86,18,27,131,0.7938931297709924
Victoria 3,52,52,27,131,0.7938931297709924
Sword of the Stars: The Pit,64,13,20,97,0.7938144329896907
One Punch Man: A Hero Nobody Knows,18,59,20,97,0.7938144329896907
The Legend of Zelda,95,5,26,126,0.7936507936507936
Just Cause 3: Sky Fortress,37,13,13,63,0.7936507936507936
WWE 2K14,189,34,58,281,0.7935943060498221
Turok 2: Seeds of Evil,91,5,25,121,0.7933884297520661
Serious Sam 4: Planet Badass,221,82,79,382,0.7931937172774869
Pokemon Pearl Version,314,35,91,440,0.7931818181818182
Shadows: Heretic Kingdoms,35,11,12,58,0.7931034482758621
Persona 3: Dancing in Moonlight,64,28,24,116,0.7931034482758621
Counter-Strike 2,62,122,48,232,0.7931034482758621
Microsoft Flight Simulator X,75,17,24,116,0.7931034482758621
Lords of Football,29,17,12,58,0.7931034482758621
Worms Rumble,44,25,18,87,0.7931034482758621
Guitar Hero Live,168,127,77,372,0.793010752688172
Kameo: Elements of Power,82,6,23,111,0.7927927927927928
Rocket Arena,43,45,23,111,0.7927927927927928
Max: The Curse of Brotherhood,249,57,80,386,0.7927461139896373
Call of Duty: Black Ops - First Strike,41,24,17,82,0.7926829268292683
Freedom Force,55,10,17,82,0.7926829268292683
Fight'N Rage,51,14,17,82,0.7926829268292683
Dead Rising 3: Operation Broken Eagle,22,43,17,82,0.7926829268292683
Tekken 7,826,370,313,1509,0.7925778661365143
Mario & Luigi: Paper Jam,151,40,50,241,0.7925311203319502
Interstellar Marines,31,11,11,53,0.7924528301886793
Suikoden Tierkreis,36,6,11,53,0.7924528301886793
Onechanbara Z2: Chaos,59,25,22,106,0.7924528301886793
One Strike,32,10,11,53,0.7924528301886793
The Mighty Quest for Epic Loot,44,40,22,106,0.7924528301886793
Nobody Saves the World,126,19,38,183,0.7923497267759563
Atelier Shallie: Alchemists of the Dusk Sea,50,11,16,77,0.7922077922077922
Nintendo Labo: Toycon 02 Robot Kit,39,22,16,77,0.7922077922077922
Blossom Tales: The Sleeping King,72,8,21,101,0.7920792079207921
Destiny: Rise of Iron,112,185,78,375,0.792
Rust,385,247,166,798,0.7919799498746867
Grand Theft Auto III,2167,144,608,2919,0.7917094895512161
Justice League Heroes,33,5,10,48,0.7916666666666666
Bloodline Champions,60,16,20,96,0.7916666666666666
Dreamscaper,30,8,10,48,0.7916666666666666
FIFA Manager 13,24,33,15,72,0.7916666666666666
Assassin's Creed III: The Hidden Secrets Pack,23,15,10,48,0.7916666666666666
Professor Layton and the Last Specter,71,5,20,96,0.7916666666666666
Rec Room,27,11,10,48,0.7916666666666666
HarmoKnight,32,6,10,48,0.7916666666666666
Star Wars Episode I: Racer,83,12,25,120,0.7916666666666666
Windward (2012),29,9,10,48,0.7916666666666666
Zoo Tycoon 2,49,8,15,72,0.7916666666666666
American Fugitive,35,22,15,72,0.7916666666666666
Dragon Age II,2588,4379,1835,8802,0.7915246534878436
FIFA Soccer 12,694,213,239,1146,0.7914485165794066
Edna & Harvey: Harvey's New Eyes,79,12,24,115,0.7913043478260869
Ninja Gaiden Sigma 2,138,25,43,206,0.7912621359223301
Kirby Mass Attack,63,9,19,91,0.7912087912087912
Syphon Filter 3,69,3,19,91,0.7912087912087912
Offworld Trading Company,59,13,19,91,0.7912087912087912
FIFA Soccer 11,424,61,128,613,0.7911908646003263
Conarium,91,34,33,158,0.7911392405063291
Space Hulk,119,59,47,225,0.7911111111111111
God Eater Resurrection,76,30,28,134,0.7910447761194029
Uplink: Hacker Elite,44,9,14,67,0.7910447761194029
Etherlords,49,4,14,67,0.7910447761194029
Cthulhu Saves the World,82,24,28,134,0.7910447761194029
Curse of the Dead Gods,82,24,28,134,0.7910447761194029
Final Fantasy V,126,14,37,177,0.7909604519774012
Mortal Kombat X,1434,396,484,2314,0.790838375108038
MechWarrior 5: Mercenaries,122,135,68,325,0.7907692307692308
Mushroom Men: The Spore Wars,31,3,9,43,0.7906976744186046
Far Cry Instincts Predator,23,11,9,43,0.7906976744186046
Humanity,88,14,27,129,0.7906976744186046
Halo 2: Anniversary,63,5,18,86,0.7906976744186046
Armies of Exigo,29,5,9,43,0.7906976744186046
L.A. Noire: The VR Case Files,22,12,9,43,0.7906976744186046
SCP: Secret Laboratory,58,10,18,86,0.7906976744186046
Ghost 1.0,29,5,9,43,0.7906976744186046
Dragon Ball: Xenoverse 2,430,106,142,678,0.7905604719764012
NCAA Football 13,39,44,22,105,0.7904761904761904
Don't Starve,1139,136,338,1613,0.7904525728456293
The Fall,113,19,35,167,0.7904191616766467
Saints Row: The Third Remastered,143,53,52,248,0.7903225806451613
Allods Online,28,21,13,62,0.7903225806451613
Karateka (2012),37,27,17,81,0.7901234567901234
Football Manager 2022,48,16,17,81,0.7901234567901234
FIFA Soccer 13,752,426,313,1491,0.790073775989269
Gunman Clive,83,11,25,119,0.7899159663865546
Fade to Silence,42,52,25,119,0.7899159663865546
Hatsune Miku: Project Diva X,78,16,25,119,0.7899159663865546
Hearthstone: Heroes of Warcraft,1278,951,593,2822,0.7898653437278526
Oddworld: Stranger's Wrath HD,139,15,41,195,0.7897435897435897
Madden NFL 13,184,116,80,380,0.7894736842105263
SpellForce 2: Faith in Destiny,17,13,8,38,0.7894736842105263
Gibbous -  A Cthulhu Adventure,30,15,12,57,0.7894736842105263
Morbid: The Seven Acolytes,22,8,8,38,0.7894736842105263
Crystal Key 2: The Far Realm,59,1,16,76,0.7894736842105263
Space Hulk Ascension,20,10,8,38,0.7894736842105263
Left 4 Dead 2: Cold Stream,25,5,8,38,0.7894736842105263
Akaneiro: Demon Hunters,18,12,8,38,0.7894736842105263
Hexcells,27,3,8,38,0.7894736842105263
Hollow (2017),21,39,16,76,0.7894736842105263
Bomb Chicken,26,4,8,38,0.7894736842105263
Team Sonic Racing,349,101,120,570,0.7894736842105263
Eldest Souls,30,15,12,57,0.7894736842105263
Borderlands 3: Bounty of Blood,20,10,8,38,0.7894736842105263
Jade Empire,267,29,79,375,0.7893333333333333
Don't Starve Together,270,37,82,389,0.7892030848329049
Madden NFL 17,70,132,54,256,0.7890625
Call of Duty: Modern Warfare 2 Campaign Remastered,350,65,111,526,0.7889733840304183
Broken Sword: Shadow of the Templars,148,9,42,199,0.7889447236180904
Overcooked!,400,41,118,559,0.7889087656529516
Heroes of Newerth,98,44,38,180,0.7888888888888889
Metroid: Other M,356,167,140,663,0.7888386123680241
Orcs Must Die! Unchained,38,18,15,71,0.7887323943661971
DeathSpank: Thongs of Virtue,51,5,15,71,0.7887323943661971
Football Manager 2016,88,24,30,142,0.7887323943661971
Star Wars Battlefront,1599,2861,1195,5655,0.78868258178603
Call of Duty: Black Ops - Escalation,41,41,22,104,0.7884615384615384
Mario and Donkey Kong: Minis on the Move,32,9,11,52,0.7884615384615384
Spider-Man 2: Enter: Electro,78,4,22,104,0.7884615384615384
Infinite Undiscovery,34,7,11,52,0.7884615384615384
Murder by Numbers,29,12,11,52,0.7884615384615384
Metro Exodus: Sam's Story,123,26,40,189,0.7883597883597884
Road 96,234,45,75,354,0.788135593220339
The Movies,114,5,32,151,0.7880794701986755
Mario & Sonic at the Rio 2016 Olympic Games,95,24,32,151,0.7880794701986755
GRID Autosport,271,134,109,514,0.7879377431906615
Super Street Fighter IV,375,41,112,528,0.7878787878787878
Heat Signature,20,6,7,33,0.7878787878787878
Dynasty Warriors: Gundam Reborn,22,4,7,33,0.7878787878787878
Strayed Lights,11,15,7,33,0.7878787878787878
Runaway: A Twist of Fate,48,4,14,66,0.7878787878787878
The Cycle: Frontier,12,14,7,33,0.7878787878787878
Shattered Horizon,21,5,7,33,0.7878787878787878
Coffee Talk Episode 2: Hibiscus & Butterfly,23,3,7,33,0.7878787878787878
Middle-earth: Shadow of War - Blade of Galadriel,10,16,7,33,0.7878787878787878
Life Goes On,20,6,7,33,0.7878787878787878
Tom Clancy's Splinter Cell: Pandora Tomorrow,270,27,80,377,0.7877984084880637
Freedom Fighters,119,22,38,179,0.7877094972067039
Warhammer: Vermintide 2,272,73,93,438,0.7876712328767124
Shadow Warrior,726,90,220,1036,0.7876447876447876
Thirty Flights of Loving,69,83,41,193,0.7875647668393783
Pokemon Picross,51,12,17,80,0.7875
Nuclear Dawn,81,19,27,127,0.7874015748031497
Pro Evolution Soccer 2015,415,192,164,771,0.7872892347600519
Satellite Reign,96,15,30,141,0.7872340425531915
Ultimate Custom Night,66,8,20,94,0.7872340425531915
Batman: Arkham City - Robin Bundle Pack,29,8,10,47,0.7872340425531915
Lumines,30,7,10,47,0.7872340425531915
Sherlock Holmes: Crimes & Punishments,466,107,155,728,0.7870879120879121
Jurassic Park: Operation Genesis,81,4,23,108,0.7870370370370371
Street Fighter X Mega Man,42,6,13,61,0.7868852459016393
Digimon Rumble Arena 2,43,5,13,61,0.7868852459016393
Dead Space 3: Awakened,54,53,29,136,0.7867647058823529
Magic: The Gathering - Duels of the Planeswalkers 2013,119,47,45,211,0.7867298578199052
WRC 8 FIA World Rally Championship,80,60,38,178,0.7865168539325843
Tomb Raider III: Adventures of Lara Croft,137,14,41,192,0.7864583333333334
Syberia II,219,16,64,299,0.7859531772575251
Oddworld: Stranger's Wrath,47,8,15,70,0.7857142857142857
Mitsurugi Kamui Hikae,20,13,9,42,0.7857142857142857
Clubhouse Games,83,27,30,140,0.7857142857142857
Imperial Glory,38,6,12,56,0.7857142857142857
Infinite Minigolf,21,12,9,42,0.7857142857142857
RONIN,35,9,12,56,0.7857142857142857
Batman: The Enemy Within - Episode 4: What Ails You,41,14,15,70,0.7857142857142857
Post Scriptum,29,4,9,42,0.7857142857142857
Ice Age: Scrat's Nutty Adventure,23,21,12,56,0.7857142857142857
Montague's Mount,13,20,9,42,0.7857142857142857
Heroes of Ruin,35,9,12,56,0.7857142857142857
Troll and I,22,44,18,84,0.7857142857142857
Pacific Rim,17,27,12,56,0.7857142857142857
Disney G-Force,40,15,15,70,0.7857142857142857
Paladins: Champions of the Realm,504,159,181,844,0.7855450236966824
Pokemon Mystery Dungeon: Blue Rescue Team,122,6,35,163,0.7852760736196319
Tactical Intervention,53,42,26,121,0.7851239669421488
Halo: The Master Chief Collection - Halo 3: ODST,67,17,23,107,0.7850467289719626
Ratchet & Clank: Full Frontal Assault,104,53,43,200,0.785
Sound Shapes,258,56,86,400,0.785
Red Steel,52,21,20,93,0.7849462365591398
World of Van Helsing: Deathtrap,61,12,20,93,0.7849462365591398
Hotshot Racing,45,17,17,79,0.7848101265822784
Corruption 2029,29,22,14,65,0.7846153846153846
Marvel vs. Capcom: Infinite,130,183,86,399,0.7844611528822055
Project CARS,628,267,246,1141,0.7843996494303243
Railworks 3: Train Simulator 2012,29,11,11,51,0.7843137254901961
Space Hulk: Deathwing,65,55,33,153,0.7843137254901961
Chasing Dead,20,20,11,51,0.7843137254901961
Perception,49,31,22,102,0.7843137254901961
PlanetSide 2,892,304,329,1525,0.7842622950819672
F1 2013,147,60,57,264,0.7840909090909091
Mortal Kombat: Deception,158,9,46,213,0.784037558685446
Carmageddon: Max Damage,61,37,27,125,0.784
They Are Billions,114,42,43,199,0.7839195979899497
The Council,198,16,59,273,0.7838827838827839
Asphalt 3D,12,17,8,37,0.7837837837837838
Suicide Guy: Sleepin' Deeply,19,10,8,37,0.7837837837837838
Call of Duty: Black Ops - Rezurrection,22,36,16,74,0.7837837837837838
Phantasy Star Portable 2,27,2,8,37,0.7837837837837838
A Knight's Quest,8,21,8,37,0.7837837837837838
Pac-Man 99,26,3,8,37,0.7837837837837838
Aarklash: Legacy,78,9,24,111,0.7837837837837838
Kerbal Space Program: Enhanced Edition,16,13,8,37,0.7837837837837838
Mario Kart 8 Deluxe: Booster Course Pass - Wave 1,20,9,8,37,0.7837837837837838
PlayStation Home,19,10,8,37,0.7837837837837838
Destiny 2: Lightfall,205,16,61,282,0.7836879432624113
Happy Wars,95,39,37,171,0.783625730994152
Skylanders Giants,108,44,42,194,0.7835051546391752
Psycho-Pass: Mandatory Happiness,33,14,13,60,0.7833333333333333
The Sims 3: Pets (2011),16,31,13,60,0.7833333333333333
Sorcery,38,9,13,60,0.7833333333333333
"Borderlands 3: Guns, Love, and Tentacles",28,19,13,60,0.7833333333333333
SSX (2000),46,1,13,60,0.7833333333333333
Test Drive: Ferrari Racing Legends,35,30,18,83,0.7831325301204819
Ghost Song,60,23,23,106,0.7830188679245284
FATE,28,8,10,46,0.782608695652174
Yu-Gi-Oh! The Duelists of the Roses,51,3,15,69,0.782608695652174
Dota Underlords,70,20,25,115,0.782608695652174
Conflict: Desert Storm,31,5,10,46,0.782608695652174
Olympic Games Tokyo 2020: The Official Video Game,27,27,15,69,0.782608695652174
Necromunda: Underhive Wars,16,20,10,46,0.782608695652174
Ace Combat Infinity,29,25,15,69,0.782608695652174
Tekken 4,136,8,40,184,0.782608695652174
Galactic Civilizations II: Dread Lords,30,6,10,46,0.782608695652174
The Wardrobe,26,10,10,46,0.782608695652174
PlayStation All-Stars Battle Royale,548,132,189,869,0.7825086306098964
Velocity 2X,335,100,121,556,0.7823741007194245
Star Ocean: Integrity and Faithlessness,141,89,64,294,0.782312925170068
Rogue Company,119,93,59,271,0.7822878228782287
The Inpatient,45,34,22,101,0.7821782178217822
The Punisher,191,10,56,257,0.7821011673151751
Creaks,92,12,29,133,0.7819548872180451
Monaco: What's Yours Is Mine,176,32,58,266,0.7819548872180451
Total War: WARHAMMER II - Rise of the Tomb Kings,33,10,12,55,0.7818181818181819
Record of Lodoss War: Deedlit in Wonder Labyrinth,40,3,12,55,0.7818181818181819
Blast Corps,42,1,12,55,0.7818181818181819
YAIBA: NINJA GAIDEN Z,70,84,43,197,0.7817258883248731
TERA,464,202,186,852,0.7816901408450704
Proteus,113,116,64,293,0.7815699658703071
DmC: Devil May Cry - Vergil's Downfall,104,57,45,206,0.7815533980582524
007 Legends,50,168,61,279,0.7813620071684588
FIFA 14,1103,1208,647,2958,0.7812711291413117
Raw Data,17,8,7,32,0.78125
Giana Sisters: Twisted Dreams - Director's Cut,60,15,21,96,0.78125
Infinite Crisis,17,8,7,32,0.78125
Total War: Rome II - Empire Divided,14,11,7,32,0.78125
Fossil Fighters: Frontier,10,15,7,32,0.78125
Horace,61,14,21,96,0.78125
Digimon Masters Online,16,9,7,32,0.78125
Vexx,204,21,63,288,0.78125
Hybrid (2012),20,5,7,32,0.78125
The Elder Scrolls III: Tribunal,66,9,21,96,0.78125
Jet Kave Adventure,16,9,7,32,0.78125
Final Fight: Streetwise,22,3,7,32,0.78125
Regalia: Of Men and Monarchs - Royal Edition,14,11,7,32,0.78125
Pineapple on pizza,21,4,7,32,0.78125
Lara Croft and the Guardian of Light,291,23,88,402,0.7810945273631841
Call of Juarez: The Cartel,103,186,81,370,0.7810810810810811
BioShock Infinite: Burial at Sea - Episode One,691,83,217,991,0.781029263370333
Crossing Souls,58,24,23,105,0.780952380952381
Monster Train,75,7,23,105,0.780952380952381
Sid Meier's Civilization VI,1334,416,491,2241,0.7809013833110219
OlliOlli World,105,34,39,178,0.7808988764044944
Sonic Boom: Shattered Crystal,80,59,39,178,0.7808988764044944
Avadon: The Black Fortress,49,8,16,73,0.7808219178082192
Roller Champions,16,41,16,73,0.7808219178082192
Kingdoms of Amalur: Re-Reckoning,150,53,57,260,0.7807692307692308
WWI Tannenberg: Eastern Front,26,6,9,41,0.7804878048780488
The Persistence,20,12,9,41,0.7804878048780488
Red Dead Redemption: Liars and Cheats,27,5,9,41,0.7804878048780488
Star Trek Bridge Commander,29,3,9,41,0.7804878048780488
"Warhammer 40,000: Darktide",57,71,36,164,0.7804878048780488
Archvale,25,7,9,41,0.7804878048780488
Game of Thrones: Episode Three - The Sword in the Darkness,141,26,47,214,0.780373831775701
GRIME,62,9,20,91,0.7802197802197802
The Sims 4,779,1624,677,3080,0.7801948051948052
Chivalry: Medieval Warfare,681,146,233,1060,0.780188679245283
NHL 2K8,212,40,71,323,0.7801857585139319
Boyfriend Dungeon,21,18,11,50,0.78
Generation Zero,138,103,68,309,0.7799352750809061
BlazBlue: Cross Tag Battle,87,37,35,159,0.779874213836478
Zombie Army 4: Dead War,136,87,63,286,0.7797202797202797
Observer,327,80,115,522,0.7796934865900383
Oddworld: Munch's Oddysee,36,10,13,59,0.7796610169491526
"Invisible, Inc.",174,24,56,254,0.7795275590551181
State of Decay,767,218,279,1264,0.7792721518987342
White Knight Chronicles II,45,15,17,77,0.7792207792207793
Warlock: Master of the Arcane,160,20,51,231,0.7792207792207793
Paradise (2006),57,3,17,77,0.7792207792207793
Eastward,140,40,51,231,0.7792207792207793
Time and Eternity,29,31,17,77,0.7792207792207793
Serious Sam: Siberian Mayhem,51,9,17,77,0.7792207792207793
Call of Duty: WWII,1255,1613,813,3681,0.7791361043194784
WWE '13,195,20,61,276,0.7789855072463768
Kirby: Nightmare in Dream Land,73,1,21,95,0.7789473684210526
Burnout Paradise Remastered,240,63,86,389,0.7789203084832905
The Texas Chain Saw Massacre,134,49,52,235,0.7787234042553192
Call of Duty: Black Ops II - Revolution,40,55,27,122,0.7786885245901639
Super Mario 3D All-Stars,453,233,195,881,0.7786606129398411
Fort Solis,68,34,29,131,0.7786259541984732
Castlevania: Circle of the Moon,108,8,33,149,0.7785234899328859
Zeno Clash II,90,26,33,149,0.7785234899328859
Snake Pass,173,59,66,298,0.7785234899328859
Hearts of Iron III,105,25,37,167,0.7784431137724551
ModNation Racers,125,19,41,185,0.7783783783783784
Resident Evil Village: Winters' Expansion,48,103,43,194,0.7783505154639175
Watch Dogs,5742,3015,2495,11252,0.778261642374689
Silent Hill 4: The Room,436,47,138,621,0.7777777777777778
The Sims 4: Island Living,11,17,8,36,0.7777777777777778
Out of Line,35,7,12,54,0.7777777777777778
Dead Block,21,7,8,36,0.7777777777777778
Civilization III: Conquests,23,5,8,36,0.7777777777777778
Cat Quest II: The Lupus Empire,71,13,24,108,0.7777777777777778
Battlefield 3: End Game,77,21,28,126,0.7777777777777778
Adam's Venture: Origins,20,57,22,99,0.7777777777777778
F1 2002,30,5,10,45,0.7777777777777778
Tom Clancy's Ghost Recon,57,20,22,99,0.7777777777777778
Super Seducer 2,22,6,8,36,0.7777777777777778
Cultist Simulator,25,10,10,45,0.7777777777777778
Urban Chaos: Riot Response,48,1,14,63,0.7777777777777778
Sky Force Anniversary,45,18,18,81,0.7777777777777778
The Legend of Legacy,37,12,14,63,0.7777777777777778
Crazy Taxi 2,27,1,8,36,0.7777777777777778
Muse Dash,46,17,18,81,0.7777777777777778
Carto,56,7,18,81,0.7777777777777778
Crysis 3 Remastered,46,3,14,63,0.7777777777777778
The Legend of Zelda: Spirit Tracks,255,28,81,364,0.7774725274725275
God of War: Ascension,1020,157,337,1514,0.7774108322324967
Battlefield 4,4308,2110,1839,8257,0.7772798837350127
Scott Pilgrim vs. the World: The Game,140,17,45,202,0.7772277227722773
The Last Campfire,127,9,39,175,0.7771428571428571
Hearthstone: Heroes of Warcraft - The Grand Tournament,35,87,35,157,0.7770700636942676
Wolfenstein: The Old Blood,1172,107,367,1646,0.7770352369380316
Anomaly 2,92,23,33,148,0.777027027027027
Dungeon Defenders,325,82,117,524,0.7767175572519084
Werewolf: The Apocalypse - Earthblood,50,103,44,197,0.7766497461928934
Sable,94,52,42,188,0.776595744680851
IGI 2: Covert Strike,61,5,19,85,0.7764705882352941
Disney/Pixar Cars,97,28,36,161,0.7763975155279503
Angry Video Game Nerd Adventures,107,18,36,161,0.7763975155279503
Teenage Mutant Ninja Turtles: Out of the Shadows,107,129,68,304,0.7763157894736842
Dungeons of Dredmor,147,23,49,219,0.776255707762557
Football Manager 2020,68,43,32,143,0.7762237762237763
EVERSPACE,81,30,32,143,0.7762237762237763
Adios,30,22,15,67,0.7761194029850746
Assassin's Creed Chronicles,62,42,30,134,0.7761194029850746
007: NightFire,138,18,45,201,0.7761194029850746
White Night,68,22,26,116,0.7758620689655172
Battlefield 4: Premium Edition,29,16,13,58,0.7758620689655172
Blacktail,34,11,13,58,0.7758620689655172
Nickelodeon Barnyard,41,4,13,58,0.7758620689655172
Star Wars Battlefront: Elite Squadron,124,4,37,165,0.7757575757575758
The Legend of Zelda: Tri Force Heroes,156,41,57,254,0.7755905511811023
Yonder: The Cloud Catcher Chronicles,87,27,33,147,0.7755102040816326
Army Men: Sarge's Heroes 2,27,11,11,49,0.7755102040816326
Planet Alpha,58,18,22,98,0.7755102040816326
Yakuza 3,171,19,55,245,0.7755102040816326
Total War: Rome Remastered,21,17,11,49,0.7755102040816326
NeuroVoider,31,7,11,49,0.7755102040816326
MLB 2K13,7,31,11,49,0.7755102040816326
Elliot Quest,28,10,11,49,0.7755102040816326
Escape Academy,36,2,11,49,0.7755102040816326
EVERSPACE 2,67,9,22,98,0.7755102040816326
Altitude,34,4,11,49,0.7755102040816326
Evil West,266,55,93,414,0.7753623188405797
Zone of the Enders HD Collection,58,11,20,89,0.7752808988764045
Titan Quest: Anniversary Edition,63,6,20,89,0.7752808988764045
Defense Grid: The Awakening,159,10,49,218,0.7752293577981652
Krater,124,38,47,209,0.7751196172248804
Heretic: Shadow of the Serpent Riders,30,1,9,40,0.775
The Hobbit: The Prelude to the Lord of the Rings,56,6,18,80,0.775
Dead In Vinland,22,9,9,40,0.775
Liberated,21,10,9,40,0.775
Root Letter,25,6,9,40,0.775
Farming Simulator 15,91,33,36,160,0.775
The Vanishing of Ethan Carter,770,98,252,1120,0.775
The Hong Kong Massacre,36,26,18,80,0.775
Hydrophobia,47,15,18,80,0.775
Green Day: Rock Band,26,5,9,40,0.775
Attack on Titan: Humanity in Chains,11,20,9,40,0.775
Need for Speed: Most Wanted,941,891,532,2364,0.7749576988155669
Bulletstorm: Full Clip Edition,189,52,70,311,0.77491961414791
Nintendo Land,417,34,131,582,0.7749140893470791
Half-Life: Source,71,15,25,111,0.7747747747747747
Resogun: Heroes,65,14,23,102,0.7745098039215687
Need for Speed Heat,853,581,418,1852,0.7742980561555075
Darkest Dungeon: The Crimson Court,17,7,7,31,0.7741935483870968
The Raven: Legacy of a Master Thief,44,28,21,93,0.7741935483870968
Empire Earth: The Art of Conquest,23,1,7,31,0.7741935483870968
TRON RUN/r,18,6,7,31,0.7741935483870968
Space Colony (2003),22,2,7,31,0.7741935483870968
Cattails,17,7,7,31,0.7741935483870968
Frozen Cortex,16,8,7,31,0.7741935483870968
Medieval Dynasty,50,22,21,93,0.7741935483870968
Banished,525,44,166,735,0.7741496598639456
Darksiders,1088,115,351,1554,0.7741312741312741
Anarchy Reigns,165,20,54,239,0.7740585774058577
FlatOut 4: Total Insanity,96,41,40,177,0.7740112994350282
FIFA 17,619,761,403,1783,0.7739764441951766
Golden Sun: Dark Dawn,84,5,26,115,0.7739130434782608
Project CARS 2,273,134,119,526,0.7737642585551331
Viva Pinata: Trouble in Paradise,39,2,12,53,0.7735849056603774
Yaga,26,15,12,53,0.7735849056603774
Cruis'n Blast,38,3,12,53,0.7735849056603774
Marvel Nemesis: Rise of the Imperfects,41,17,17,75,0.7733333333333333
Euro Truck Simulator 2: Go East,51,7,17,75,0.7733333333333333
Dirge of Cerberus: Final Fantasy VII,179,29,61,269,0.7732342007434945
War of the Roses,116,102,64,282,0.7730496453900709
Star Trek Online,175,104,82,361,0.7728531855955678
Scooby-Doo! Night of 100 Frights,29,5,10,44,0.7727272727272727
Super Time Force,128,59,55,242,0.7727272727272727
Ace Attorney Investigations: Miles Edgeworth,79,6,25,110,0.7727272727272727
Project X Zone,96,23,35,154,0.7727272727272727
Duke Nukem 3D: Megaton Edition,22,12,10,44,0.7727272727272727
Labyrinth of Refrain: Coven of Dusk,43,8,15,66,0.7727272727272727
Immortal Legacy: The Jade Cipher,27,7,10,44,0.7727272727272727
Awesomenauts,356,55,121,532,0.7725563909774437
Humankind,87,42,38,167,0.7724550898203593
Chasm,71,24,28,123,0.7723577235772358
Pro Evolution Soccer 2013,373,102,140,615,0.7723577235772358
Slain: Back from Hell,51,27,23,101,0.7722772277227723
Football Manager 2015,88,51,41,180,0.7722222222222223
LEGO Marvel Super Heroes,778,100,259,1137,0.772207563764292
Grand Ages: Medieval,34,27,18,79,0.7721518987341772
X3: Reunion,36,8,13,57,0.7719298245614035
NBA Live 18,77,55,39,171,0.7719298245614035
"Harry Potter and the Deathly Hallows, Part 2",52,80,39,171,0.7719298245614035
LEGO Dimensions,123,36,47,206,0.7718446601941747
The Legend of Spyro: Dawn of the Dragon (2008),105,47,45,197,0.7715736040609137
DiRT 4,256,75,98,429,0.7715617715617715
Dragon Age II: The Black Emporium,23,58,24,105,0.7714285714285715
Nintendo Wii,25,2,8,35,0.7714285714285715
Uncharted: Fight for Fortune,34,20,16,70,0.7714285714285715
Redshirt,12,15,8,35,0.7714285714285715
Tales of Monkey Island Chapter 5: Rise of the Pirate God,23,4,8,35,0.7714285714285715
Dungeon Punks,15,12,8,35,0.7714285714285715
Milk inside a bag of milk inside a bag of milk,26,1,8,35,0.7714285714285715
Jak X: Combat Racing,95,13,32,140,0.7714285714285715
Smuggler's Run,17,10,8,35,0.7714285714285715
Full Mojo Rampage,22,5,8,35,0.7714285714285715
Bodycount (2011),30,61,27,118,0.7711864406779662
2010 FIFA World Cup South Africa,79,12,27,118,0.7711864406779662
The Room,141,14,46,201,0.7711442786069652
Carnivores: Dinosaur Hunter,22,15,11,48,0.7708333333333334
Super Animal Royale,31,6,11,48,0.7708333333333334
The Sims Bustin' Out,33,4,11,48,0.7708333333333334
Mario Golf: Toadstool Tour,35,2,11,48,0.7708333333333334
The Walking Dead: The Telltale Series - A New Frontier Episode 2: Ties That Bind Part Two,86,25,33,144,0.7708333333333334
Crown Trick,30,7,11,48,0.7708333333333334
Dungeon Siege,186,19,61,266,0.7706766917293233
DARK (2013),67,185,75,327,0.7706422018348624
SSX On Tour,40,7,14,61,0.7704918032786885
Double Dragon IV,28,19,14,61,0.7704918032786885
Vampire: The Masquerade - Redemption,98,6,31,135,0.7703703703703704
Resident Evil 6,2333,1799,1232,5364,0.7703206562266965
PlayerUnknown's Battlegrounds,727,1134,555,2416,0.7702814569536424
Xenosaga Episode II: Jenseits von Gut und Bose,46,11,17,74,0.7702702702702703
Gods Will Be Watching,74,40,34,148,0.7702702702702703
Hitman - Episode 5: Colorado,44,13,17,74,0.7702702702702703
The Incredible Adventures of Van Helsing II,161,33,58,252,0.7698412698412699
Call of the Sea,254,47,90,391,0.7698209718670077
Hitman: Definitive Edition,92,15,32,139,0.7697841726618705
"Warhammer 40,000: Dawn of War II",316,45,108,469,0.7697228144989339
Twelve Minutes,424,308,219,951,0.7697160883280757
Pro Evolution Soccer 2014,168,370,161,699,0.7696709585121603
The Legend of Korra,207,77,85,369,0.7696476964769647
Ben 10: Omniverse,28,12,12,52,0.7692307692307693
Warriors: Legends of Troy,24,6,9,39,0.7692307692307693
The Long Journey Home,20,10,9,39,0.7692307692307693
Drawn to Life,23,7,9,39,0.7692307692307693
Far Cry 4: Valley of the Yetis,78,22,30,130,0.7692307692307693
Daymare: 1994 Sandcastle,16,14,9,39,0.7692307692307693
Resident Evil Outbreak File #2,74,6,24,104,0.7692307692307693
Sonic Classic Collection,25,5,9,39,0.7692307692307693
Pac-Man World Rally,25,5,9,39,0.7692307692307693
Metal Slug 3,124,36,48,208,0.7692307692307693
Disney/Pixar Toy Story 3,142,28,51,221,0.7692307692307693
Aviary Attorney,25,5,9,39,0.7692307692307693
City of Brass,22,38,18,78,0.7692307692307693
John Wick Hex,29,41,21,91,0.7692307692307693
Family Guy: Back to the Multiverse,45,68,34,147,0.7687074829931972
Marvel: Ultimate Alliance,285,44,99,428,0.7686915887850467
A Total War Saga: TROY,126,90,65,281,0.7686832740213523
Moebius: Empire Rising,57,36,28,121,0.768595041322314
Hey! Pikmin,51,22,22,95,0.7684210526315789
Hitman,726,90,246,1062,0.768361581920904
V-Rally 4,34,29,19,82,0.7682926829268293
Tchia,86,40,38,164,0.7682926829268293
Dead by Daylight,633,680,396,1709,0.7682855471035693
Age of Empires: Definitive Edition,130,49,54,233,0.7682403433476395
Expeditions: Conquistador,155,14,51,220,0.7681818181818182
Pathfinder: Kingmaker - Definitive Edition,25,28,16,69,0.7681159420289855
Guitar Hero: Warriors of Rock,73,23,29,125,0.768
Tower of Time,74,12,26,112,0.7678571428571429
Breach (2011),22,21,13,56,0.7678571428571429
STRAFE,19,24,13,56,0.7678571428571429
The Expanse: A Telltale Series,26,17,13,56,0.7678571428571429
Dinner Date,5,28,10,43,0.7674418604651163
Jagged Alliance 2: Unfinished Business,26,7,10,43,0.7674418604651163
The Adventure Pals,48,18,20,86,0.7674418604651163
Sengoku,46,20,20,86,0.7674418604651163
Akane,27,6,10,43,0.7674418604651163
Emily is Away Too,30,3,10,43,0.7674418604651163
Ben 10 Omniverse 2,13,20,10,43,0.7674418604651163
This is the Police 2,59,30,27,116,0.7672413793103449
Driver 2,93,19,34,146,0.7671232876712328
LEGO Harry Potter: Years 5-7,207,40,75,322,0.7670807453416149
Pokemon Sword / Shield: The Isle of Armor,185,220,123,528,0.7670454545454546
2014 FIFA World Cup Brazil,67,91,48,206,0.7669902912621359
Sid Meier's Civilization: Beyond Earth - Rising Tide,67,35,31,133,0.7669172932330827
Overcooked! 2,289,30,97,416,0.7668269230769231
Tom Clancy's Ghost Recon: Wildlands - Narco Road,6,17,7,30,0.7666666666666667
The Last Tinker: City of Colors,42,27,21,90,0.7666666666666667
Sid Meier's Gettysburg!,16,7,7,30,0.7666666666666667
Sally Face,43,3,14,60,0.7666666666666667
Journey of the Broken Circle,18,5,7,30,0.7666666666666667
The Sims 3: Late Night Expansion Pack,37,32,21,90,0.7666666666666667
Hard Reset: Exile,17,6,7,30,0.7666666666666667
Special Forces: Team X,33,13,14,60,0.7666666666666667
Marvel's Guardians of the Galaxy - Episode 1: Tangled Up in Blue,54,38,28,120,0.7666666666666667
The Last Door (2014),39,7,14,60,0.7666666666666667
Metal Gear Solid 2: Sons of Liberty,96,42,42,180,0.7666666666666667
King Arthur: Knight's Tale,40,6,14,60,0.7666666666666667
I Am Dead,17,6,7,30,0.7666666666666667
The White Door,19,4,7,30,0.7666666666666667
Lego Universe,19,4,7,30,0.7666666666666667
Pac-Man and the Ghostly Adventures 2,14,9,7,30,0.7666666666666667
Warlords Battlecry III,22,1,7,30,0.7666666666666667
Batman: Arkham City - Challenge Map Pack,21,2,7,30,0.7666666666666667
Digimon World: Dusk,19,4,7,30,0.7666666666666667
The Last Door: Season 2,19,4,7,30,0.7666666666666667
Total War: WARHAMMER II - Curse of the Vampire Coast,19,4,7,30,0.7666666666666667
Driver: San Francisco,546,91,194,831,0.766546329723225
Yakuza 5 Remastered,113,15,39,167,0.7664670658682635
Solasta: Crown of the Magister,65,17,25,107,0.7663551401869159
DreadOut,52,30,25,107,0.7663551401869159
Styx: Shards of Darkness,145,32,54,231,0.7662337662337663
Super Stardust HD,48,11,18,77,0.7662337662337663
Pony Island,166,37,62,265,0.7660377358490567
Armed and Dangerous,28,8,11,47,0.7659574468085106
Heaven's Vault,22,14,11,47,0.7659574468085106
Crash Bandicoot 2: N-Tranced,65,7,22,94,0.7659574468085106
Saints Row 2,576,85,202,863,0.7659327925840093
Manhunt 2,168,25,59,252,0.7658730158730159
Dragon Age: Origins - Awakening,500,26,161,687,0.7656477438136827
Atelier Rorona: The Alchemist of Arland,41,8,15,64,0.765625
Tropico 3,61,1,19,81,0.7654320987654321
Tom Clancy's Ghost Recon: Wildlands,1094,500,489,2083,0.7652424387902065
Cities in Motion,76,12,27,115,0.7652173913043478
Song of the Deep,73,15,27,115,0.7652173913043478
Retro City Rampage,140,26,51,217,0.7649769585253456
Dragon Age II: Legacy,85,120,63,268,0.7649253731343284
Layers of Fear 2,139,92,71,302,0.7649006622516556
BloodRayne 2,208,36,75,319,0.7648902821316614
Code:Realize - Guardian of Rebirth,43,9,16,68,0.7647058823529411
Tokyo Xanadu,23,3,8,34,0.7647058823529411
Eldritch,29,10,12,51,0.7647058823529411
The Count Lucanor,43,9,16,68,0.7647058823529411
NORCO,48,17,20,85,0.7647058823529411
World War Z: Aftermath,15,11,8,34,0.7647058823529411
Minecraft: Story Mode - Season Two: The Telltale Series,36,29,20,85,0.7647058823529411
Baldi's Basics in Education and Learning,12,14,8,34,0.7647058823529411
Darkest Dungeon II,48,43,28,119,0.7647058823529411
EverQuest II,41,11,16,68,0.7647058823529411
Sacred Underworld,19,7,8,34,0.7647058823529411
Chivalry: Deadliest Warrior,41,11,16,68,0.7647058823529411
Neversong,22,4,8,34,0.7647058823529411
Double Dragon: Neon,108,25,41,174,0.764367816091954
Tribes of Midgard,53,28,25,106,0.7641509433962265
Burnout Dominator,64,4,21,89,0.7640449438202247
Dune 2000,66,2,21,89,0.7640449438202247
EA Sports WRC,47,21,21,89,0.7640449438202247
House Flipper,156,35,59,250,0.764
Blair Witch,444,242,212,898,0.7639198218262806
Uncanny Valley,20,35,17,72,0.7638888888888888
Trials of the Blood Dragon,35,20,17,72,0.7638888888888888
PixelJunk Shooter,48,7,17,72,0.7638888888888888
Hitman - Episode 3: Marrakesh,71,26,30,127,0.7637795275590551
RAGE: The Scorchers,28,14,13,55,0.7636363636363637
Darwinia+,31,11,13,55,0.7636363636363637
Puzzle & Dragons Z + Puzzle & Dragons: Super Mario Bros. Edition,34,8,13,55,0.7636363636363637
Tales of Monkey Island Chapter 1: Launch of the Screaming Narwhal,34,8,13,55,0.7636363636363637
MAG,68,16,26,110,0.7636363636363637
Bloodforge,32,10,13,55,0.7636363636363637
Men of Valor,74,39,35,148,0.7635135135135135
They Bleed Pixels,58,13,22,93,0.7634408602150538
Fallout 4: Nuka-World,137,121,80,338,0.7633136094674556
Accounting+,21,8,9,38,0.7631578947368421
Endless Space: Disharmony,20,9,9,38,0.7631578947368421
Accel World vs. Sword Art Online: Millennium Twilight,20,9,9,38,0.7631578947368421
The Great Perhaps,21,8,9,38,0.7631578947368421
Star Wars: Jedi Starfighter,26,3,9,38,0.7631578947368421
Broforce,430,63,153,646,0.7631578947368421
The Survivalists,19,10,9,38,0.7631578947368421
Ministry of Broadcast,26,3,9,38,0.7631578947368421
The Denpa Men: They Came By Wave,24,5,9,38,0.7631578947368421
Pokemon Colosseum,136,9,45,190,0.7631578947368421
Mr. Shifty,42,16,18,76,0.7631578947368421
Star Wars Galactic Battlegrounds,52,6,18,76,0.7631578947368421
The Entropy Centre,25,4,9,38,0.7631578947368421
Minion Masters,23,6,9,38,0.7631578947368421
Untitled Goose Game,344,78,131,553,0.7631103074141049
Blue Dragon,90,13,32,135,0.762962962962963
NBA Live 15,65,38,32,135,0.762962962962963
RiME,470,93,175,738,0.7628726287262872
Whispers of a Machine,37,8,14,59,0.7627118644067796
Way of the Samurai 4,37,8,14,59,0.7627118644067796
Ironcast,36,9,14,59,0.7627118644067796
Call of Duty: Black Ops III - Awakening,22,23,14,59,0.7627118644067796
Five Nights at Freddy's: Sister Location,182,43,70,295,0.7627118644067796
Eagle Flight,34,11,14,59,0.7627118644067796
CONSORTIUM,34,11,14,59,0.7627118644067796
Ittle Dew,41,4,14,59,0.7627118644067796
Bulletstorm,1162,158,411,1731,0.7625649913344887
Loop Hero,165,18,57,240,0.7625
SkyDrift,48,13,19,80,0.7625
NHL 16,109,90,62,261,0.7624521072796935
Overlord II,168,18,58,244,0.7622950819672131
Saint Seiya: Soldiers' Soul,91,18,34,143,0.7622377622377622
Death's Gambit,99,26,39,164,0.7621951219512195
Destiny,3610,2799,2000,8409,0.7621595909144964
Red Faction,170,19,59,248,0.7620967741935484
The Artful Escape,154,35,59,248,0.7620967741935484
Tomodachi Life,183,22,64,269,0.7620817843866171
Element4l,26,6,10,42,0.7619047619047619
StarDrive 2,42,38,25,105,0.7619047619047619
Europa Universalis III: Divine Wind,31,1,10,42,0.7619047619047619
Grow Up,46,18,20,84,0.7619047619047619
World in Conflict: Soviet Assault,47,1,15,63,0.7619047619047619
The Path,44,20,20,84,0.7619047619047619
Battlefield 2: Modern Combat,51,13,20,84,0.7619047619047619
The Showdown Effect,48,16,20,84,0.7619047619047619
Spear of Destiny (2017),28,20,15,63,0.7619047619047619
FIFA 99,30,2,10,42,0.7619047619047619
Shadows: Awakening,46,18,20,84,0.7619047619047619
Midnight Club: LA Remix,28,4,10,42,0.7619047619047619
Wipeout HD,74,6,25,105,0.7619047619047619
Game Dev Tycoon,876,84,301,1261,0.7613005551149881
Rebel Galaxy,135,34,53,222,0.7612612612612613
Colin McRae Rally 2005,50,1,16,67,0.7611940298507462
Powerstar Golf,58,44,32,134,0.7611940298507462
Castlevania (1998),40,11,16,67,0.7611940298507462
Oxenfree,496,65,176,737,0.7611940298507462
Rollers of the Realm,41,10,16,67,0.7611940298507462
Crab Game,46,5,16,67,0.7611940298507462
The Saboteur,358,37,124,519,0.7610789980732178
Beholder,216,26,76,318,0.7610062893081762
Liberation Maiden,32,3,11,46,0.7608695652173914
Crossout,63,42,33,138,0.7608695652173914
Ben and Ed,24,11,11,46,0.7608695652173914
Darkspore,59,46,33,138,0.7608695652173914
Hitman - Episode 4: Bangkok,53,17,22,92,0.7608695652173914
The Procession to Calvary,33,2,11,46,0.7608695652173914
Fable Anniversary,220,98,100,418,0.7607655502392344
Dynasty Warriors 7,74,15,28,117,0.7606837606837606
Titanfall: Frontier's Edge,33,21,17,71,0.7605633802816901
Star Fox 64 3D,202,14,68,284,0.7605633802816901
Outcast: Second Contact,31,23,17,71,0.7605633802816901
Subnautica: Below Zero,221,87,97,405,0.7604938271604939
Mario Golf: World Tour,67,6,23,96,0.7604166666666666
DeathSpank,127,19,46,192,0.7604166666666666
Star Wars Pinball,57,16,23,96,0.7604166666666666
Friday the 13th: The Game,322,176,157,655,0.7603053435114504
Ace of Spades: Battle Builder,163,214,119,496,0.7600806451612904
I-Ninja,35,3,12,50,0.76
Hitman - Episode 6: Hokkaido,29,9,12,50,0.76
Hearthstone: Heroes of Warcraft - One Night in Karazhan,12,26,12,50,0.76
Digimon World DS,32,6,12,50,0.76
Vampire Rain,7,31,12,50,0.76
Afterimage,31,7,12,50,0.76
The SpongeBob SquarePants Movie,99,15,36,150,0.76
Borderlands,1800,227,641,2668,0.7597451274362819
Raji: An Ancient Epic,112,27,44,183,0.7595628415300546
The Evil Within: The Executioner,42,18,19,79,0.759493670886076
Zombie Army Trilogy,173,48,70,291,0.7594501718213058
Crysis,253,110,115,478,0.7594142259414226
Napoleon: Total War,280,23,96,399,0.7593984962406015
Divinity: Dragon Commander,149,53,64,266,0.7593984962406015
Mini Ninjas,118,24,45,187,0.7593582887700535
GoldenEye 007 (2010),161,22,58,241,0.7593360995850622
Ninja Gaiden 3: Razor's Edge,176,48,71,295,0.7593220338983051
Symphony (2012),35,6,13,54,0.7592592592592593
NASCAR '14,16,25,13,54,0.7592592592592593
Hyper Scape,46,77,39,162,0.7592592592592593
Gray Matter,73,9,26,108,0.7592592592592593
Rad Rodgers,23,18,13,54,0.7592592592592593
Car Mechanic Simulator 2021,31,10,13,54,0.7592592592592593
Rock Band 4,86,40,40,166,0.7590361445783133
Mario Party,120,6,40,166,0.7590361445783133
Tales of Monkey Island,59,4,20,83,0.7590361445783133
Rad,41,22,20,83,0.7590361445783133
WWE 2K17,110,107,69,286,0.7587412587412588
The Sims 3 Supernatural,27,17,14,58,0.7586206896551724
Attack of the Friday Monsters! A Tokyo Tale,36,8,14,58,0.7586206896551724
Banjo-Kazooie: Nuts & Bolts,103,73,56,232,0.7586206896551724
NES Remix,89,21,35,145,0.7586206896551724
Remnant: From the Ashes,532,184,228,944,0.7584745762711864
Coffee Talk,109,26,43,178,0.7584269662921348
Blue Estate,82,31,36,149,0.7583892617449665
Twisted Metal: Head-On - Extra Twisted Edition,73,18,29,120,0.7583333333333333
Just Cause 4,321,526,270,1117,0.7582811101163832
Broken Age: Act 2,70,46,37,153,0.7581699346405228
Dungeons & Dragons: Chronicles of Mystara,82,34,37,153,0.7581699346405228
Mount & Blade: Warband - Viking Conquest,41,6,15,62,0.7580645161290323
The Beast Inside,72,22,30,124,0.7580645161290323
Mega Man X7,14,33,15,62,0.7580645161290323
Sonic Origins Plus,34,13,15,62,0.7580645161290323
Kirby 64: The Crystal Shards,92,2,30,124,0.7580645161290323
Red Faction: Guerrilla Re-Mars-tered,51,43,30,124,0.7580645161290323
Firewatch,1494,404,606,2504,0.7579872204472844
Has-Been Heroes,91,28,38,157,0.7579617834394905
Yu-Gi-Oh! Legacy of the Duelist,97,22,38,157,0.7579617834394905
Sid Meier's Civilization Revolution,123,21,46,190,0.7578947368421053
Mortal Kombat: Armageddon,161,8,54,223,0.757847533632287
NHL 18,37,85,39,161,0.7577639751552795
Call of Duty: Advanced Warfare,1920,1710,1161,4791,0.7576706324358171
THE HOUSE OF THE DEAD: Remake,54,21,24,99,0.7575757575757576
Vampire: The Masquerade - Shadows of New York,18,7,8,33,0.7575757575757576
Return to Mysterious Island,21,4,8,33,0.7575757575757576
Leisure Suit Larry: Love for Sail!,24,1,8,33,0.7575757575757576
Griftlands,38,12,16,66,0.7575757575757576
Forza Horizon: Rally Expansion Pack,19,6,8,33,0.7575757575757576
Resident Evil 7: biohazard - Banned Footage Vol. 2,38,12,16,66,0.7575757575757576
The Swords of Ditto: Mormo's Curse,16,9,8,33,0.7575757575757576
Assassin's Creed Odyssey: Story Arc II - The Fate of Atlantis,18,7,8,33,0.7575757575757576
SpinTires,112,16,41,169,0.757396449704142
Yoshi's Island DS,98,5,33,136,0.7573529411764706
Broken Sword 5: The Serpent's Curse,195,39,75,309,0.7572815533980582
Aliens: Fireteam Elite,129,80,67,276,0.7572463768115942
FNaF World,74,32,34,140,0.7571428571428571
Battlestations: Pacific,46,7,17,70,0.7571428571428571
Iratus: Lord of the Dead,45,8,17,70,0.7571428571428571
FIFA 15,848,904,563,2315,0.7568034557235421
OMG Zombies,22,6,9,37,0.7567567567567568
Sacred 2: Gold Edition,24,4,9,37,0.7567567567567568
Quantum Theory,17,39,18,74,0.7567567567567568
Hamilton's Great Adventure,20,8,9,37,0.7567567567567568
Paper Sorcerer,20,8,9,37,0.7567567567567568
King's Quest Chapter 4: Snow Place Like Home,11,17,9,37,0.7567567567567568
Dakar Desert Rally,23,5,9,37,0.7567567567567568
Teenage Mutant Ninja Turtles 3: Mutant Nightmare,23,5,9,37,0.7567567567567568
Power Stone 2,27,1,9,37,0.7567567567567568
Naruto: Clash of Ninja Revolution,19,9,9,37,0.7567567567567568
Rain,122,18,45,185,0.7567567567567568
Drake Hollow,17,11,9,37,0.7567567567567568
The Crew 2,311,342,210,863,0.7566628041714948
The Walking Dead: The Telltale Series - A New Frontier Episode 5: From The Gallows,51,36,28,115,0.7565217391304347
Adventure Time: Hey Ice King! Why'd You Steal Our Garbage?!!,45,14,19,78,0.7564102564102564
Call of Duty: Black Ops,2909,1414,1393,5716,0.7562981105668299
Batman: Arkham Origins,2527,348,927,3802,0.7561809573908469
Metroid,29,2,10,41,0.7560975609756098
Turok: Dinosaur Hunter,90,3,30,123,0.7560975609756098
Drug Dealer Simulator,20,11,10,41,0.7560975609756098
Devil Daggers,48,14,20,82,0.7560975609756098
Final Fantasy IV: The After Years,20,11,10,41,0.7560975609756098
Blue Fire,51,11,20,82,0.7560975609756098
Omega Strikers,26,5,10,41,0.7560975609756098
Kinect Sports,85,11,31,127,0.7559055118110236
ASTRONEER,174,52,73,299,0.7558528428093646
Outlast 2,927,268,386,1581,0.7558507273877293
Gun,250,10,84,344,0.7558139534883721
1-2-Switch,146,213,116,475,0.7557894736842106
Spider-Man 2: The Game,31,68,32,131,0.7557251908396947
Torchlight III,25,74,32,131,0.7557251908396947
Five Nights at Freddy's 3,379,150,171,700,0.7557142857142857
The Lord of the Rings Online: Shadows of Angmar,120,16,44,180,0.7555555555555555
Windbound,38,30,22,90,0.7555555555555555
One Piece: Unlimited World Red - Deluxe Edition,23,11,11,45,0.7555555555555555
Warsaw,23,11,11,45,0.7555555555555555
Tokyo Ghoul: re Call to Exist,21,13,11,45,0.7555555555555555
NASCAR Heat Evolution,7,27,11,45,0.7555555555555555
Snoopy's Grand Adventure,23,11,11,45,0.7555555555555555
Knockout City,99,40,45,184,0.7554347826086957
Kingdom: New Lands,108,31,45,184,0.7554347826086957
Sonic Adventure DX Director's Cut,490,62,179,731,0.7551299589603283
Aliens Versus Predator: Gold Edition,35,2,12,49,0.7551020408163265
Burnout Crash!,22,15,12,49,0.7551020408163265
DreamWorks Shrek Smash n' Crash Racing,25,12,12,49,0.7551020408163265
The Basement Collection,33,4,12,49,0.7551020408163265
GreedFall,821,159,318,1298,0.7550077041602465
Five Nights at Freddy's 4,258,121,123,502,0.7549800796812749
Skater XL,55,59,37,151,0.7549668874172185
Rise of the Tomb Raider: Baba Yaga - The Temple of the Witch,58,19,25,102,0.7549019607843137
Blackguards 2,63,17,26,106,0.7547169811320755
Hammerfight,15,25,13,53,0.7547169811320755
Paradise Lost,26,14,13,53,0.7547169811320755
Leisure Suit Larry: Wet Dreams Don't Dry,58,25,27,110,0.7545454545454545
GRIP: Combat Racing,50,33,27,110,0.7545454545454545
Super Mario Bros.,119,7,41,167,0.7544910179640718
My Memory of Us,28,15,14,57,0.7543859649122807
Leisure Suit Larry: Magna Cum Laude,25,21,15,61,0.7540983606557377
Sports Champions,89,6,31,126,0.753968253968254
Bus Simulator 18,32,17,16,65,0.7538461538461538
Monkey King: Hero is Back,32,17,16,65,0.7538461538461538
Trials Evolution: Gold Edition,76,25,33,134,0.753731343283582
Five Nights at Freddy's 2,301,54,116,471,0.7537154989384289
SteamWorld Dig,495,65,183,743,0.7537012113055181
Kingdom Hearts Re:coded,183,25,68,276,0.7536231884057971
Republique Remastered,31,21,17,69,0.7536231884057971
Football Manager 2019,80,27,35,142,0.7535211267605634
Spore Galactic Adventures,41,14,18,73,0.7534246575342466
Spear of Destiny,49,6,18,73,0.7534246575342466
LEGO Harry Potter Collection,98,21,39,158,0.7531645569620253
The Solus Project,40,21,20,81,0.7530864197530864
Mario Super Sluggers,56,5,20,81,0.7530864197530864
Mortal Kombat 11: Aftermath,80,42,40,162,0.7530864197530864
Headlander,52,12,21,85,0.7529411764705882
Delta Force: Black Hawk Down,56,11,22,89,0.7528089887640449
Forsaken World,31,36,22,89,0.7528089887640449
Sid Meier's Civilization VI: Gathering Storm,49,18,22,89,0.7528089887640449
Driver: Parallel Lines,86,54,46,186,0.7526881720430108
Ultra Street Fighter II: The Final Challengers,100,40,46,186,0.7526881720430108
Syberia 3,117,102,72,291,0.7525773195876289
The Legend of Zelda: Phantom Hourglass,339,29,121,489,0.7525562372188139
Daylight,68,163,76,307,0.752442996742671
Two Point Hospital,263,50,103,416,0.7524038461538461
Ziggurat,68,11,26,105,0.7523809523809524
Castlevania: Lords of Shadow - Mirror of Fate,262,63,107,432,0.7523148148148148
Bendy and the Ink Machine,133,43,58,234,0.7521367521367521
Space Engineers,75,19,31,125,0.752
Toki Tori 2,80,17,32,129,0.751937984496124
Primal Carnage,82,18,33,133,0.7518796992481203
The Walking Dead: Michonne - Episode 1: In Too Deep,139,76,71,286,0.7517482517482518
SpeedRunners,94,15,36,145,0.7517241379310344
Dino D-Day,66,46,37,149,0.7516778523489933
H1Z1: Battle Royale,27,94,40,161,0.7515527950310559
Metal Gear Solid V: Ground Zeroes,1519,712,738,2969,0.7514314584035029
Warriors Orochi 2,152,2,51,205,0.751219512195122
Metal: Hellsinger,139,24,54,217,0.7511520737327189
Peggle,163,27,63,253,0.7509881422924901
The Sims 3,883,175,351,1409,0.7508871540099361
Split/Second,241,24,88,353,0.7507082152974505
Tony Hawk's Underground 2 Remix,486,197,227,910,0.7505494505494505
"Warhammer 40,000: Space Marine",740,126,288,1154,0.7504332755632582
Heretic Kingdoms: The Inquisition,16,8,8,32,0.75
Global Agenda,39,21,20,80,0.75
The Testament of Sherlock Holmes,162,21,61,244,0.75
Avatar: The Last Airbender - The Burning Earth,12,15,9,36,0.75
Medal of Honor: Frontline,155,7,54,216,0.75
JoJo's Bizarre Adventure: Eyes of Heaven,116,19,45,180,0.75
Bloody Roar 3,40,20,20,80,0.75
Party Hard 2,22,8,10,40,0.75
Neo Cab,31,17,16,64,0.75
A Normal Lost Phone,23,7,10,40,0.75
Dr Kawashima's Brain Training for Nintendo Switch,20,10,10,40,0.75
Life is Strange: True Colors - Wavelengths,29,31,20,80,0.75
Breathedge,50,19,23,92,0.75
Mortal Shell,401,208,203,812,0.75
Turba,22,5,9,36,0.75
Tony Hawk's Downhill Jam,20,7,9,36,0.75
Stella Deus: The Gate of Eternity,75,18,31,124,0.75
50 Cent: Bulletproof,14,16,10,40,0.75
Clock Tower 3,25,5,10,40,0.75
Always Sometimes Monsters,47,19,22,88,0.75
Battlefield 4: Final Stand,17,10,9,36,0.75
Fantasy General II: Invasion,27,9,12,48,0.75
The Occupation,13,26,13,52,0.75
Mario vs. Donkey Kong (2004),38,1,13,52,0.75
Psi-Ops: The Mindgate Conspiracy,37,5,14,56,0.75
Tokobot,30,15,15,60,0.75
Dungeons & Dragons Online: Stormreach,20,10,10,40,0.75
Port Royale 3: Pirates and Merchants,46,26,24,96,0.75
Digimon World: Dawn,25,5,10,40,0.75
Dynasty Warriors 8,82,11,31,124,0.75
Cibele,7,17,8,32,0.75
Blade Symphony,21,9,10,40,0.75
Lovers in a Dangerous Spacetime,107,22,43,172,0.75
Actual Sunlight,23,13,12,48,0.75
Pure Hold 'Em,7,17,8,32,0.75
Redeemer: Enhanced Edition,25,5,10,40,0.75
Reventure,27,6,11,44,0.75
Quake Champions,81,24,35,140,0.75
Bakugan Battle Brawlers,61,20,27,108,0.75
King Arthur: The Role-Playing Wargame,55,14,23,92,0.75
Toree 3D,22,2,8,32,0.75
Virtua Fighter 5 Ultimate Showdown,27,15,14,56,0.75
Terminator: Resistance Enhanced,24,6,10,40,0.75
Call of Duty 2: Big Red One,78,24,34,136,0.75
Obscure,106,8,38,152,0.75
Harvest Moon: The Tale of Two Towns,25,14,13,52,0.75
Mighty Switch Force!,41,4,15,60,0.75
Midnight Club II,87,9,32,128,0.75
Shadowrun (working title),16,20,12,48,0.75
Kathy Rain,68,7,25,100,0.75
Disney/Pixar Toy Story 2: Buzz Lightyear to the Rescue!,82,5,29,116,0.75
KAO the Kangaroo (2000),21,6,9,36,0.75
Gravity Ghost,15,9,8,32,0.75
Ninjin: Clash of Carrots,18,15,11,44,0.75
Death Road to Canada,62,13,25,100,0.75
Minecraft Dungeons: Ultimate Edition,20,7,9,36,0.75
Perfect World International,23,10,11,44,0.75
Killing Floor 2,236,69,102,407,0.7493857493857494
Condemned: Criminal Origins,265,19,95,379,0.7493403693931399
Dear Esther,370,186,186,742,0.7493261455525606
Sanctum (2011),130,52,61,243,0.7489711934156379
Tekken 6,285,49,112,446,0.7488789237668162
NHL 17,70,79,50,199,0.7487437185929648
Game of Thrones,263,178,148,589,0.7487266553480475
Uncharted: Drake's Fortune,2575,237,944,3756,0.7486687965921193
Mass Effect 3: Leviathan,206,71,93,370,0.7486486486486487
OlliOlli2: Welcome to Olliwood,185,83,90,358,0.7486033519553073
Hitman: Absolution,1784,410,737,2931,0.7485499829409757
Void Bastards,98,30,43,171,0.7485380116959064
OlliOlli,91,25,39,155,0.7483870967741936
Grand Theft Auto IV: The Lost and Damned,448,42,165,655,0.7480916030534351
Wii Party,90,5,32,127,0.7480314960629921
Fallout 3: Point Lookout,161,17,60,238,0.7478991596638656
Knytt Underground,64,25,30,119,0.7478991596638656
Tekken 2,165,7,58,230,0.7478260869565218
Overlord,238,17,86,341,0.7478005865102639
Trackmania Turbo,208,47,86,341,0.7478005865102639
Football Manager 2018,50,33,28,111,0.7477477477477478
Bridge Constructor Portal,50,33,28,111,0.7477477477477478
Destroy All Humans! (2005),68,9,26,103,0.7475728155339806
POSTAL Redux,57,17,25,99,0.7474747474747475
Dead Synchronicity: Tomorrow Comes Today,59,15,25,99,0.7474747474747475
Cities: Skylines II,30,109,47,186,0.7473118279569892
Harry Potter and the Order of the Phoenix,431,51,163,645,0.7472868217054264
The Unfinished Swan,241,31,92,364,0.7472527472527473
The Godfather,217,31,84,332,0.7469879518072289
LEGO City Undercover: The Chase Begins,44,18,21,83,0.7469879518072289
Luftrausers,145,35,61,241,0.7468879668049793
Titan Quest,359,57,141,557,0.7468581687612208
Football Manager 2023,38,21,20,79,0.7468354430379747
The Adventures of Tintin: The Game,41,18,20,79,0.7468354430379747
Toki Tori,93,25,40,158,0.7468354430379747
DG2: Defense Grid 2,86,29,39,154,0.7467532467532467
Castlevania: Harmony of Despair,46,10,19,75,0.7466666666666667
DUST 514,100,68,57,225,0.7466666666666667
Skul: The Hero Slayer,40,16,19,75,0.7466666666666667
The Order: 1886,2190,877,1041,4108,0.7465920155793574
WRC 4: FIA World Rally Championship,74,35,37,146,0.7465753424657534
Kirby Battle Royale,41,12,18,71,0.7464788732394366
The Incredible Hulk: Ultimate Destruction,45,5,17,67,0.746268656716418
"Yes, Your Grace",83,17,34,134,0.746268656716418
Anno 2205,148,102,85,335,0.746268656716418
Of Orcs and Men,160,87,84,331,0.7462235649546828
Test Drive: Eve of Destruction,145,37,62,244,0.7459016393442623
Just Dance 2019,77,14,31,122,0.7459016393442623
Gato Roboto,76,15,31,122,0.7459016393442623
Jazzpunk,119,16,46,181,0.7458563535911602
Freddy Fazbear's Pizzeria Simulator,73,15,30,118,0.7457627118644068
The Sims 3 Seasons,35,9,15,59,0.7457627118644068
Overlord: Raising Hell,41,3,15,59,0.7457627118644068
TimeSplitters,41,3,15,59,0.7457627118644068
The Sims 3: World Adventures,35,9,15,59,0.7457627118644068
Teenage Mutant Ninja Turtles 2: Battle Nexus,34,10,15,59,0.7457627118644068
The Mageseeker: A League of Legends Story,32,12,15,59,0.7457627118644068
Alpha Protocol,436,89,179,704,0.7457386363636364
Vampyr,1081,341,485,1907,0.7456738332459361
Dead Pixels,33,8,14,55,0.7454545454545455
Riptide GP: Renegade,27,14,14,55,0.7454545454545455
Crimsonland,63,19,28,110,0.7454545454545455
Her Story,261,143,138,542,0.7453874538745388
Cat Quest,146,15,55,216,0.7453703703703703
Mulaka,60,19,27,106,0.7452830188679245
Still Life,69,10,27,106,0.7452830188679245
Infested Planet,34,4,13,51,0.7450980392156863
Mafia II: Definitive Edition,326,241,194,761,0.7450722733245729
Far Cry Primal,1428,527,669,2624,0.745045731707317
Ace Combat: Assault Horizon,95,51,50,196,0.7448979591836735
Final Fantasy II,59,14,25,98,0.7448979591836735
Sonic Chronicles: The Dark Brotherhood,49,24,25,98,0.7448979591836735
Rift (2011),345,93,150,588,0.7448979591836735
Fight Night Round 4,61,12,25,98,0.7448979591836735
LittleBigPlanet 3,502,149,223,874,0.7448512585812357
Minecraft: Story Mode - A Telltale Games Series - The Complete Adventure,102,35,47,184,0.7445652173913043
Massive Chalice,67,35,35,137,0.7445255474452555
The Forest (2014),513,93,208,814,0.7444717444717445
F1 2015,60,74,46,180,0.7444444444444445
Magic Duels: Origins,36,31,23,90,0.7444444444444445
Combat Arms,40,59,34,133,0.7443609022556391
Second Sight,55,9,22,86,0.7441860465116279
Dungeons 2,72,24,33,129,0.7441860465116279
Tree of Savior,22,10,11,43,0.7441860465116279
"Warhammer 40,000: Battlesector",29,3,11,43,0.7441860465116279
Zombie Night Terror,28,4,11,43,0.7441860465116279
Xuan-Yuan Sword 7,24,8,11,43,0.7441860465116279
Tropico 6,126,60,64,250,0.744
Rise of Venice,43,18,21,82,0.7439024390243902
3D Dot Game Heroes,52,9,21,82,0.7439024390243902
Final Fantasy XIII,1232,839,713,2784,0.7438936781609196
Hard West,116,32,51,199,0.7437185929648241
Master of Orion 3,6,23,10,39,0.7435897435897436
Neighbours back From Hell,27,2,10,39,0.7435897435897436
NASCAR 2011: The Game,10,19,10,39,0.7435897435897436
FIFA Street,27,2,10,39,0.7435897435897436
Hero Siege,37,21,20,78,0.7435897435897436
Shu,20,9,10,39,0.7435897435897436
Twisted Metal: Head-On,25,4,10,39,0.7435897435897436
Bugs Bunny & Taz: Time Busters,28,1,10,39,0.7435897435897436
JoJo's Bizarre Adventure: All-Star Battle R,43,15,20,78,0.7435897435897436
Far Cry,772,83,295,1150,0.7434782608695653
Pokemon Stadium 2,112,1,39,152,0.743421052631579
Sniper Elite: Nazi Zombie Army,152,42,67,261,0.7432950191570882
PixelJunk Monsters: Ultimate HD,45,10,19,74,0.7432432432432432
Rainbow Islands Revolution,54,1,19,74,0.7432432432432432
The Lord of the Rings: The Two Towers,105,5,38,148,0.7432432432432432
Blacksad: Under the Skin,88,48,47,183,0.7431693989071039
Sacred Gold,25,1,9,35,0.7428571428571429
Prince of Persia Rival Swords,21,5,9,35,0.7428571428571429
Super Stardust Ultra,20,6,9,35,0.7428571428571429
Blood Omen 2,72,6,27,105,0.7428571428571429
Megaquarium,18,8,9,35,0.7428571428571429
Earthworm Jim HD,23,3,9,35,0.7428571428571429
Chime,23,3,9,35,0.7428571428571429
Frobisher Says!,42,10,18,70,0.7428571428571429
Record of Agarest War Zero,32,20,18,70,0.7428571428571429
Eternights,47,5,18,70,0.7428571428571429
Owlboy,354,85,152,591,0.7428087986463621
Strike Suit Zero,146,59,71,276,0.7427536231884058
SUPERHOT,649,90,256,995,0.742713567839196
Sonic Advance,94,7,35,136,0.7426470588235294
Disney DuckTales: Remastered,342,59,139,540,0.7425925925925926
Apache: Air Assault,37,12,17,66,0.7424242424242424
"Warhammer 40,000: Kill Team",33,16,17,66,0.7424242424242424
Wave Race 64,96,2,34,132,0.7424242424242424
Eiyuden Chronicle: Rising,49,23,25,97,0.7422680412371134
Remember Me,1194,254,503,1951,0.7421834956432599
Blood Bowl: Chaos Edition,14,9,8,31,0.7419354838709677
AirBuccaneers,14,9,8,31,0.7419354838709677
JYDGE,19,4,8,31,0.7419354838709677
Pokemon Rumble U,32,37,24,93,0.7419354838709677
Virtua Tennis 3,39,7,16,62,0.7419354838709677
Castlevania: Lords of Shadow 2 - Revelations,21,2,8,31,0.7419354838709677
Alone With You (2017),14,9,8,31,0.7419354838709677
Croixleur Sigma,16,7,8,31,0.7419354838709677
Strategic Mind: The Pacific,22,1,8,31,0.7419354838709677
Dead or School,13,10,8,31,0.7419354838709677
The Swords of Ditto,30,16,16,62,0.7419354838709677
FIFA World Cup: Germany 2006,39,7,16,62,0.7419354838709677
PixelJunk Shooter 2,20,3,8,31,0.7419354838709677
Shovel Knight Dig,20,3,8,31,0.7419354838709677
Miasma Chronicles,41,5,16,62,0.7419354838709677
Realpolitiks,15,8,8,31,0.7419354838709677
Desert Child,15,8,8,31,0.7419354838709677
Odium (1999),22,1,8,31,0.7419354838709677
Dynasty Warriors 6,51,18,24,93,0.7419354838709677
Fate/Extella: The Umbral Star,69,20,31,120,0.7416666666666667
Rayman,60,6,23,89,0.7415730337078652
Fallen Earth: Welcome to the Apocalypse,43,23,23,89,0.7415730337078652
Shadow Warrior 3,103,72,61,236,0.7415254237288136
Home Sweet Home (2018),28,15,15,58,0.7413793103448276
Have a Nice Death,37,6,15,58,0.7413793103448276
Farming Simulator 19,87,62,52,201,0.7412935323383084
Ghostbusters: The Video Game Remastered,71,35,37,143,0.7412587412587412
Knack,670,352,357,1379,0.7411167512690355
Kirby Star Allies,353,76,150,579,0.7409326424870466
Peter Jackson's King Kong: The Official Game of the Movie,179,24,71,274,0.7408759124087592
Pine,25,15,14,54,0.7407407407407407
Greak: Memories of Azur,34,6,14,54,0.7407407407407407
Warriors All-Stars,34,6,14,54,0.7407407407407407
Gatling Gears,32,8,14,54,0.7407407407407407
Trepang2,34,6,14,54,0.7407407407407407
"Warhammer 40,000: Dawn of War - Soulstorm",130,10,49,189,0.7407407407407407
Fallout 3: Broken Steel,155,19,61,235,0.7404255319148936
The Mummy Demastered,42,15,20,77,0.7402597402597403
Trine 5: A Clockwork Conspiracy,49,8,20,77,0.7402597402597403
Fatal Frame II: Crimson Butterfly,81,33,40,154,0.7402597402597403
Saints Row IV,1544,436,695,2675,0.7401869158878505
Totally Accurate Battle Simulator,84,10,33,127,0.7401574803149606
Fable II,562,50,215,827,0.7400241837968561
Left 4 Dead: Crash Course,34,3,13,50,0.74
Condemned 2: Bloodshot,134,14,52,200,0.74
Dishonored: Dunwall City Trials,61,13,26,100,0.74
Dynasty Warriors: Gundam 3,32,5,13,50,0.74
Blitzkrieg (2003),33,4,13,50,0.74
Randal's Monday,40,14,19,73,0.7397260273972602
Spyro: Enter the Dragonfly,36,72,38,146,0.7397260273972602
Armello,94,31,44,169,0.7396449704142012
"Snipperclips Plus: Cut It Out, Together!",68,3,25,96,0.7395833333333334
Unreal Tournament III,214,33,87,334,0.7395209580838323
Brothers in Arms: Hell's Highway,155,21,62,238,0.7394957983193278
Starbound,307,73,134,514,0.7392996108949417
The Bug Butcher,29,5,12,46,0.7391304347826086
DARQ: Complete Edition,30,4,12,46,0.7391304347826086
Fantasy Wars,31,3,12,46,0.7391304347826086
Dr. Luigi,42,9,18,69,0.7391304347826086
inFamous: Festival of Blood,146,4,53,203,0.7389162561576355
NHL 13,85,31,41,157,0.7388535031847133
Lords of the Fallen (2014),753,370,397,1520,0.7388157894736842
Dragon Ball Z: Battle of Z,96,82,63,241,0.7385892116182573
"Warhammer 40,000: Dawn of War II - Retribution",183,26,74,283,0.7385159010600707
Garshasp: The Monster Slayer,28,20,17,65,0.7384615384615385
Midtown Madness 2,47,1,17,65,0.7384615384615385
Those Who Remain,26,22,17,65,0.7384615384615385
Beyond A Steel Sky,35,13,17,65,0.7384615384615385
Sam & Max: Save the World,45,3,17,65,0.7384615384615385
Cloudpunk,98,29,45,172,0.7383720930232558
Volgarr the Viking,102,25,45,172,0.7383720930232558
Far Cry 4,3622,577,1488,5687,0.7383506242307016
Battlefield Hardline,771,1142,678,2591,0.7383249710536472
"That Dragon, Cancer",46,33,28,107,0.7383177570093458
James Bond 007: Everything or Nothing,72,7,28,107,0.7383177570093458
Super Motherload,56,23,28,107,0.7383177570093458
NHL 07,23,8,11,42,0.7380952380952381
Blur,306,35,121,462,0.7380952380952381
Tetris Ultimate,22,40,22,84,0.7380952380952381
ONRUSH,117,69,66,252,0.7380952380952381
Assassin's Creed: Brotherhood - The Da Vinci Disappearance,58,4,22,84,0.7380952380952381
Creed: Rise to Glory,19,12,11,42,0.7380952380952381
Anno 1800 Console Edition,26,5,11,42,0.7380952380952381
Black The Fall,51,25,27,103,0.7378640776699029
Assassin's Creed III - The Infamy,58,63,43,164,0.7378048780487805
Far Cry Classic,62,28,32,122,0.7377049180327869
Lead and Gold: Gangs of the Wild West,38,7,16,61,0.7377049180327869
Mind Zero,28,17,16,61,0.7377049180327869
Medal of Honor: Warfighter,526,523,373,1422,0.7376933895921237
Ruiner,218,35,90,343,0.7376093294460642
WarioWare: Smooth Moves,103,1,37,141,0.7375886524822695
Shadow Complex Remastered,57,16,26,99,0.7373737373737373
Mafia III,1152,1939,1101,4192,0.7373568702290076
Earth 2160,73,14,31,118,0.7372881355932204
Steep,296,133,153,582,0.7371134020618557
STALCRAFT,25,3,10,38,0.7368421052631579
Bright Memory,38,60,35,133,0.7368421052631579
Starseed Pilgrim,17,11,10,38,0.7368421052631579
Choo-Choo Charles,27,15,15,57,0.7368421052631579
Rusty Hearts,30,12,15,57,0.7368421052631579
Aliens: Infestation,26,2,10,38,0.7368421052631579
Pool Nation FX,12,16,10,38,0.7368421052631579
Knights Contract,17,11,10,38,0.7368421052631579
The Dwarves,46,38,30,114,0.7368421052631579
Earth's Dawn,20,8,10,38,0.7368421052631579
The Jackbox Party Pack 2,23,5,10,38,0.7368421052631579
Moonscars,32,24,20,76,0.7368421052631579
Risen 2: Dark Waters,386,336,258,980,0.736734693877551
Dead Rising,289,66,127,482,0.7365145228215768
Iron Harvest,93,41,48,182,0.7362637362637363
The Surge,380,167,196,743,0.7362045760430687
Observation,164,48,76,288,0.7361111111111112
Viewtiful Joe,100,6,38,144,0.7361111111111112
LEGO Star Wars: The Force Awakens,210,52,94,356,0.7359550561797753
The Cave (2013),290,50,122,462,0.7359307359307359
Sludge Life,30,9,14,53,0.7358490566037735
Scratches,33,6,14,53,0.7358490566037735
Pandora: First Contact,32,7,14,53,0.7358490566037735
DOOM 3,810,73,317,1200,0.7358333333333333
Battlefield Vietnam,94,9,37,140,0.7357142857142858
Teslagrad,217,39,92,348,0.735632183908046
Axiom Verge 2,54,35,32,121,0.7355371900826446
ETHER One,53,61,41,155,0.7354838709677419
Costume Quest,177,12,68,257,0.7354085603112841
Sonic Forces,1113,643,632,2388,0.7353433835845896
The Sims 3: University Life,38,12,18,68,0.7352941176470589
The Sims: Hot Date,21,4,9,34,0.7352941176470589
GWENT: Rogue Mage,12,13,9,34,0.7352941176470589
Soldner-X 2: Final Prototype,20,5,9,34,0.7352941176470589
Alien Shooter: Vengeance,20,5,9,34,0.7352941176470589
Mario Party 5,66,9,27,102,0.7352941176470589
Heavy Metal: F.A.K.K. 2,22,3,9,34,0.7352941176470589
Not Tonight,18,7,9,34,0.7352941176470589
"Time Gentlemen, Please!",19,6,9,34,0.7352941176470589
Primal Fears,7,18,9,34,0.7352941176470589
Excitebike 64,24,1,9,34,0.7352941176470589
Tetris Axis,19,6,9,34,0.7352941176470589
Gryphon Knight Epic,20,5,9,34,0.7352941176470589
Anna's Quest,39,11,18,68,0.7352941176470589
Hard West 2,20,5,9,34,0.7352941176470589
Xeodrifter,61,50,40,151,0.7350993377483444
Immortal Redneck,46,15,22,83,0.7349397590361446
Stealth Inc: A Clone in the Dark,54,7,22,83,0.7349397590361446
The Bard's Tale,78,19,35,132,0.7348484848484849
The Gunk,142,88,83,313,0.7348242811501597
CastleStorm,138,31,61,230,0.7347826086956522
Wolfenstein 3D,282,31,113,426,0.7347417840375586
MIND: Path to Thalamus,49,23,26,98,0.7346938775510204
UnderMine,32,4,13,49,0.7346938775510204
The Haunted: Hell's Reach,30,6,13,49,0.7346938775510204
Nitroplus Blasterz: Heroines Infinite Duel,27,9,13,49,0.7346938775510204
Joe Dever's Lone Wolf HD Remastered,27,9,13,49,0.7346938775510204
Everybody 1-2-Switch!,20,16,13,49,0.7346938775510204
Dungeons & Dragons: Daggerdale,23,60,30,113,0.7345132743362832
Chariot,71,12,30,113,0.7345132743362832
The Sims 4: Outdoor Retreat,26,21,17,64,0.734375
Star Ocean: The Last Hope - 4K & Full HD Remaster,37,10,17,64,0.734375
Sid Meier's Starships,32,73,38,143,0.7342657342657343
Magrunner: Dark Pulse,44,14,21,79,0.7341772151898734
Madden NFL 25,177,182,130,489,0.7341513292433538
Fuse (2013),109,87,71,267,0.7340823970037453
Bulb Boy,55,14,25,94,0.7340425531914894
R-Type Command,69,11,29,109,0.7339449541284404
Shadow of the Tomb Raider,2095,511,945,3551,0.7338777809067868
Grand Theft Auto: Liberty City Stories,361,33,143,537,0.7337057728119181
Grey Goo,126,31,57,214,0.7336448598130841
Need for Speed: Rivals,751,802,564,2117,0.7335852621634388
Tom Clancy's HAWX 2,40,48,32,120,0.7333333333333333
1979 Revolution: Black Friday,69,19,32,120,0.7333333333333333
Betrayer,80,19,36,135,0.7333333333333333
Fortnite: LEGO Fortnite,16,6,8,30,0.7333333333333333
Behind the Frame: The Finest Scenery,17,5,8,30,0.7333333333333333
Mario Power Tennis,74,3,28,105,0.7333333333333333
Trapped Dead,14,30,16,60,0.7333333333333333
Rocketbirds 2: Evolution,16,6,8,30,0.7333333333333333
Delta Force,21,1,8,30,0.7333333333333333
MXGP: The Official Motocross Videogame,30,14,16,60,0.7333333333333333
One Piece: Romance Dawn,15,7,8,30,0.7333333333333333
FaceBreaker,11,11,8,30,0.7333333333333333
Kirby's Blowout Blast,16,6,8,30,0.7333333333333333
The Escapists,111,43,56,210,0.7333333333333333
Ricochet (2004),28,16,16,60,0.7333333333333333
Aura Kingdom,16,6,8,30,0.7333333333333333
Lego Racers 2,19,3,8,30,0.7333333333333333
NBA 2K10,35,9,16,60,0.7333333333333333
Endless Space,345,70,151,566,0.7332155477031802
Madden NFL 11,87,42,47,176,0.7329545454545454
Persona 5: Dancing in Starlight,86,51,50,187,0.732620320855615
Project Gotham Racing 3,56,7,23,86,0.7325581395348837
Paper Mario: Sticker Star,222,238,168,628,0.732484076433121
Batman: The Telltale Series - Episode 3: New World Order,64,18,30,112,0.7321428571428571
Knowledge is Power,32,9,15,56,0.7321428571428571
MX vs. ATV Reflex,30,11,15,56,0.7321428571428571
For the King,82,30,41,153,0.7320261437908496
The Dark Pictures Anthology: Little Hope,399,120,190,709,0.7320169252468265
BioShock Remastered,120,22,52,194,0.7319587628865979
Unturned,130,42,63,235,0.7319148936170212
Moonlighter,322,60,140,522,0.7318007662835249
Pac-Man Party,16,14,11,41,0.7317073170731707
Rayman Raving Rabbids: TV Party,16,14,11,41,0.7317073170731707
Masters of Anima,17,13,11,41,0.7317073170731707
Railroad Tycoon 3,27,3,11,41,0.7317073170731707
Far Cry 5: Hours of Darkness,48,72,44,164,0.7317073170731707
Star Wars: Shadows of the Empire,26,4,11,41,0.7317073170731707
The Last Remnant,135,34,62,231,0.7316017316017316
Jurassic Park: The Game,102,195,109,406,0.7315270935960592
Fall Guys,994,330,486,1810,0.7314917127071823
Crash Bash,143,15,58,216,0.7314814814814815
Trine 2: Complete Story,265,40,112,417,0.7314148681055156
White Knight Chronicles International Edition,35,14,18,67,0.7313432835820896
Anna,20,29,18,67,0.7313432835820896
Dragon Ball Z: Infinite World,43,6,18,67,0.7313432835820896
Outland,126,21,54,201,0.7313432835820896
Disney Infinity 2.0 Edition,56,42,36,134,0.7313432835820896
FIFA Soccer 10,195,50,90,335,0.7313432835820896
Divinity II: Ego Draconis,86,20,39,145,0.7310344827586207
Fe,104,59,60,223,0.7309417040358744
Rusty Lake Hotel,33,5,14,52,0.7307692307692307
Dead to Rights,31,7,14,52,0.7307692307692307
Pokemon Ranger: Shadows of Almia,54,3,21,78,0.7307692307692307
Battlefield 1943,115,7,45,167,0.7305389221556886
Burnout Paradise,711,88,295,1094,0.7303473491773309
Lollipop Chainsaw,309,81,144,534,0.7303370786516854
Enemy Front,106,116,82,304,0.7302631578947368
Assassin's Creed Syndicate,2613,829,1272,4714,0.7301654645736105
Nintendo Switch Sports,100,84,68,252,0.7301587301587301
Silent Hill: Origins,200,38,88,326,0.7300613496932515
Hearthstone: Heroes of Warcraft - Curse of Naxxramas,46,27,27,100,0.73
Final Fantasy I & II: Dawn of Souls,52,2,20,74,0.7297297297297297
IL-2 Sturmovik: Birds of Prey,19,8,10,37,0.7297297297297297
Impire,47,61,40,148,0.7297297297297297
Memento Mori,24,3,10,37,0.7297297297297297
Jump Force: Deluxe Edition,21,6,10,37,0.7297297297297297
Conception II: Children of the Seven Stars,93,23,43,159,0.7295597484276729
Dead Rising 3: Apocalypse Edition,156,138,109,403,0.7295285359801489
Ghostbusters: The Video Game,226,14,89,329,0.729483282674772
Silent Hill: Book of Memories,38,59,36,133,0.7293233082706767
Metal Saga,62,8,26,96,0.7291666666666666
Sonic Advance 2,62,8,26,96,0.7291666666666666
Game of Thrones: Episode Five - A Nest of Vipers,76,29,39,144,0.7291666666666666
The Raven Remastered,21,14,13,48,0.7291666666666666
Insanely Twisted Shadow Planet,68,10,29,107,0.7289719626168224
Shadwen,26,17,16,59,0.7288135593220338
Necropolis,18,25,16,59,0.7288135593220338
Gloomhaven,30,13,16,59,0.7288135593220338
Blackguards,144,44,70,258,0.7286821705426356
Galactic Civilizations III,140,48,70,258,0.7286821705426356
WRC 3: FIA World Rally Championship,40,11,19,70,0.7285714285714285
Pure Chess,32,19,19,70,0.7285714285714285
Worms 4: Mayhem,44,7,19,70,0.7285714285714285
Alan Wake: The Signal,37,14,19,70,0.7285714285714285
Intrusion 2,44,15,22,81,0.7283950617283951
Sword Art Online: Lost Song,62,37,37,136,0.7279411764705882
Ace Combat Assault Horizon: Enhanced Edition,76,63,52,191,0.7277486910994765
Spider-Man: Web of Shadows,310,48,134,492,0.7276422764227642
Crysis Warhead,391,23,155,569,0.7275922671353251
Mortal Kombat II,21,3,9,33,0.7272727272727273
Tyranny: Bastard's Wound,17,7,9,33,0.7272727272727273
Crackdown,143,33,66,242,0.7272727272727273
Smoke and Sacrifice,13,11,9,33,0.7272727272727273
Creature in the Well,36,20,21,77,0.7272727272727273
SteamWorld Quest: Hand of Gilgamech,66,14,30,110,0.7272727272727273
Brothers in Arms: Road to Hill 30,118,18,51,187,0.7272727272727273
Serial Cleaner,54,18,27,99,0.7272727272727273
The Walking Dead: The Telltale Series - A New Frontier Episode 4: Thicker than Water,43,29,27,99,0.7272727272727273
MechaNika,21,3,9,33,0.7272727272727273
Sinner: Sacrifice for Redemption,14,34,18,66,0.7272727272727273
Bionic Commando Rearmed 2,12,12,9,33,0.7272727272727273
The Sims 3: Island Paradise,14,10,9,33,0.7272727272727273
Battlefield 1942: The Road to Rome,28,4,12,44,0.7272727272727273
Amplitude,32,8,15,55,0.7272727272727273
Shelter 2,22,10,12,44,0.7272727272727273
Assassin's Creed Odyssey: Story Arc 1 - Legacy of the First Blade: Episode 2,19,37,21,77,0.7272727272727273
SkateBIRD,3,21,9,33,0.7272727272727273
Need for Speed: Hot Pursuit,898,246,430,1574,0.7268106734434562
Dead Island,2827,942,1418,5187,0.7266242529400424
Dead State,46,23,26,95,0.7263157894736842
PokePark Wii: Pikachu's Adventure,56,5,23,84,0.7261904761904762
Just Dance 4,88,18,40,146,0.726027397260274
Steel Storm: Burning Retribution,26,27,20,73,0.726027397260274
The Swindle,33,20,20,73,0.726027397260274
Naruto to Boruto: Shinobi Striker,96,63,60,219,0.726027397260274
Beholder 2,48,5,20,73,0.726027397260274
Iron Man 2,12,33,17,62,0.7258064516129032
Zombie Vikings,34,11,17,62,0.7258064516129032
Metroid Prime: Hunters,104,23,48,175,0.7257142857142858
Street Fighter IV,477,105,220,802,0.7256857855361596
Immortals Fenyx Rising: A New God,6,31,14,51,0.7254901960784313
The Next Big Thing,31,6,14,51,0.7254901960784313
Sword and Fairy: Together Forever,26,11,14,51,0.7254901960784313
Magic: Duels of the Planeswalkers 2014,71,53,47,171,0.7251461988304093
Titan Souls,135,76,80,291,0.7250859106529209
Ecolibrium,15,14,11,40,0.725
Dwarfs!?,24,5,11,40,0.725
Card Hunter,24,5,11,40,0.725
Quest for Infamy,24,5,11,40,0.725
Transformers Prime: The Game,14,15,11,40,0.725
Dynasty Warriors 5: Xtreme Legends,57,1,22,80,0.725
Fae Farm,19,10,11,40,0.725
This Is the Police,213,32,93,338,0.7248520710059172
Tower of Guns,80,49,49,178,0.7247191011235955
One Piece: Pirate Warriors,41,9,19,69,0.7246376811594203
Empire: Total War,550,84,241,875,0.7245714285714285
F1 2011,159,38,75,272,0.7242647058823529
Heroes of Might and Magic V: Hammers of Fate,62,1,24,87,0.7241379310344828
Hearthstone: Heroes of Warcraft - Blackrock Mountain,31,32,24,87,0.7241379310344828
A Total War Saga: Thrones of Britannia,63,63,48,174,0.7241379310344828
Dark Souls III: Ashes of Ariandel,285,69,135,489,0.7239263803680982
Alone in the Dark: The New Nightmare,89,8,37,134,0.7238805970149254
Medal of Honor: Allied Assault - Spearhead,49,6,21,76,0.7236842105263158
Borderlands: The Zombie Island of Dr. Ned,167,66,89,322,0.7236024844720497
Dicey Dungeons,81,8,34,123,0.7235772357723578
Langrisser I & II,26,8,13,47,0.723404255319149
Reservoir Dogs,49,19,26,94,0.723404255319149
Mad Riders,23,11,13,47,0.723404255319149
Job Simulator,61,7,26,94,0.723404255319149
SpongeBob's Truth or Square,26,8,13,47,0.723404255319149
Brutal Legend,533,71,231,835,0.7233532934131737
World of Warcraft,93,56,57,206,0.7233009708737864
Naruto Shippuden: Ultimate Ninja Storm Revolution,174,56,88,318,0.7232704402515723
Cyber Shadow,90,25,44,159,0.7232704402515723
Jurassic World Evolution,296,75,142,513,0.723196881091618
Just Cause 2,1008,102,425,1535,0.7231270358306189
Wii Music,20,27,18,65,0.7230769230769231
Electronic Super Joy,35,12,18,65,0.7230769230769231
Bound by Flame,382,200,223,805,0.7229813664596273
Zelda II: The Adventure of Link,41,19,23,83,0.7228915662650602
Madden NFL 15,186,116,116,418,0.722488038277512
Tales of Legendia,24,2,10,36,0.7222222222222222
Need for Speed Underground Rivals,22,4,10,36,0.7222222222222222
Unity of Command,41,11,20,72,0.7222222222222222
Tribes: Vengeance,24,2,10,36,0.7222222222222222
Blood Bowl 2,78,39,45,162,0.7222222222222222
Train Simulator 2015,10,16,10,36,0.7222222222222222
Full Spectrum Warrior,32,7,15,54,0.7222222222222222
Planet of the Apes: Last Frontier,20,19,15,54,0.7222222222222222
Steel Diver: Sub Wars,35,4,15,54,0.7222222222222222
Digimon World Data Squad,29,10,15,54,0.7222222222222222
Mini Motorways,32,7,15,54,0.7222222222222222
Resistance: Fall of Man,330,34,140,504,0.7222222222222222
"Cook, Serve, Delicious! 2!!",21,5,10,36,0.7222222222222222
Sniper Elite 5,142,84,87,313,0.7220447284345048
Spider-Man: Shattered Dimensions,309,26,129,464,0.7219827586206896
Infected (2005),49,21,27,97,0.7216494845360825
LittleBigPlanet Karting,108,32,54,194,0.7216494845360825
Assassin's Creed Chronicles: Russia,57,83,54,194,0.7216494845360825
Scribblenauts Unlimited,229,30,100,359,0.7214484679665738
Back to the Future: The Game - Episode V: OUTATIME,34,10,17,61,0.7213114754098361
Whispering Willows,66,22,34,122,0.7213114754098361
Agent A: A Puzzle In Disguise,34,10,17,61,0.7213114754098361
The Dark Pictures Anthology: The Devil in Me,103,96,77,276,0.7210144927536232
Carrier Command: Gaea Mission,33,29,24,86,0.7209302325581395
Heavenly Bodies,20,11,12,43,0.7209302325581395
Sonic Riders,144,11,60,215,0.7209302325581395
The Last Federation,22,9,12,43,0.7209302325581395
Grand Theft Auto,83,10,36,129,0.7209302325581395
Shadow Warrior Classic Redux,30,1,12,43,0.7209302325581395
Ice Age: Dawn Of The Dinosaurs,26,5,12,43,0.7209302325581395
Myst,18,13,12,43,0.7209302325581395
Tell Me Why: Chapter 1,19,12,12,43,0.7209302325581395
EA Sports UFC 2,142,116,100,358,0.7206703910614525
Assassin's Creed Odyssey: Story Arc 1 - Legacy of the First Blade: Episode 3,22,27,19,68,0.7205882352941176
Total Overdose: A Gunslinger's Tale in Mexico,99,17,45,161,0.7204968944099379
Blitz: The League,81,35,45,161,0.7204968944099379
Tiny Brains,46,21,26,93,0.7204301075268817
Borderlands 2: Captain Scarlett and Her Pirate's Booty,129,23,59,211,0.7203791469194313
Dead Space: Extraction,87,16,40,143,0.7202797202797203
Terminator Salvation (2009),44,95,54,193,0.7202072538860104
Major League Baseball 2K11,25,11,14,50,0.72
TT Isle of Man: Ride On The Edge 2,19,17,14,50,0.72
The Lord of the Rings: The Third Age,67,5,28,100,0.72
Ravaged,30,24,21,75,0.72
Absolver,83,66,58,207,0.7198067632850241
LEGO Worlds,135,60,76,271,0.7195571955719557
Painkiller: Hell & Damnation,120,57,69,246,0.7195121951219512
Halo: Spartan Strike,40,19,23,82,0.7195121951219512
Poppy Playtime,44,15,23,82,0.7195121951219512
Strider,336,82,163,581,0.7194492254733219
Rick and Morty: Virtual Rick-ality,25,16,16,57,0.7192982456140351
Monopoly Plus,56,67,48,171,0.7192982456140351
Control: The Foundation,54,28,32,114,0.7192982456140351
Fist of the North Star: Ken's Rage,36,10,18,64,0.71875
Megabyte Punch,18,5,9,32,0.71875
SOCOM: U.S. Navy SEALs,22,1,9,32,0.71875
Pac-Man,15,8,9,32,0.71875
Surgeon Simulator 2: Access All Areas,9,14,9,32,0.71875
Lair,25,21,18,64,0.71875
MotoGP 13,26,20,18,64,0.71875
Sportsfriends,44,25,27,96,0.71875
Dr. Mario: Miracle Cure,17,6,9,32,0.71875
Lucha Libre AAA Heroes del Ring,19,4,9,32,0.71875
FIFA Manager 11,11,12,9,32,0.71875
New Super Mario Bros. U Deluxe,239,70,121,430,0.7186046511627907
Jenny LeClue - Detectivu,42,9,20,71,0.7183098591549296
Gothic 3,497,97,233,827,0.7182587666263603
Mario Kart: Super Circuit,185,24,82,291,0.718213058419244
Wild Guns Reloaded,24,4,11,39,0.717948717948718
Namco Museum,23,5,11,39,0.717948717948718
The Journey Down: Chapter Two,23,5,11,39,0.717948717948718
Assassin's Creed II: Discovery,21,7,11,39,0.717948717948718
The House of Da Vinci,24,4,11,39,0.717948717948718
Tembo the Badass Elephant,63,21,33,117,0.717948717948718
Wytchwood,22,6,11,39,0.717948717948718
We Happy Few,177,156,131,464,0.7176724137931034
RAGE,1140,875,793,2808,0.7175925925925926
Anodyne,43,23,26,92,0.717391304347826
Flashback,42,57,39,138,0.717391304347826
Grotesque Tactics: Evil Heroes,18,15,13,46,0.717391304347826
Panzer Corps 2,19,14,13,46,0.717391304347826
Code of Princess,55,11,26,92,0.717391304347826
Doctor Who: The Eternity Clock,20,13,13,46,0.717391304347826
South of the Circle,19,14,13,46,0.717391304347826
'Splosion Man,84,48,52,184,0.717391304347826
WRC 7,51,20,28,99,0.7171717171717171
Thief,1346,930,898,3174,0.7170762444864525
The Typing of The Dead: Overkill,31,7,15,53,0.7169811320754716
Armored Core 4,28,10,15,53,0.7169811320754716
Mega Man X6,54,22,30,106,0.7169811320754716
Spyro: A Hero's Tail,70,11,32,113,0.7168141592920354
Forza Horizon 5: Rally Adventure,30,13,17,60,0.7166666666666667
Craft the World,41,2,17,60,0.7166666666666667
We. The Revolution,36,12,19,67,0.7164179104477612
Northgard,87,14,40,141,0.7163120567375887
Kingdom of Paradise,38,15,21,74,0.7162162162162162
The Town of Light,79,32,44,155,0.7161290322580646
The Outer Worlds: Peril on Gorgon,72,44,46,162,0.7160493827160493
Resistance 2,325,58,152,535,0.7158878504672898
Loadout,299,89,154,542,0.7158671586715867
Tropico 4,300,30,131,461,0.7158351409978309
BioShock 2 Remastered,60,18,31,109,0.7155963302752294
Joe Danger,60,18,31,109,0.7155963302752294
Polarium,73,20,37,130,0.7153846153846154
My Friend Pedro,357,40,158,555,0.7153153153153153
Thymesia,154,47,80,281,0.7153024911032029
Space Pirates and Zombies,97,16,45,158,0.7151898734177216
Saints Row IV: Re-Elected,181,45,90,316,0.7151898734177216
Dementium II,28,12,16,56,0.7142857142857143
The Suffering: Ties That Bind,47,8,22,77,0.7142857142857143
The Old City: Leviathan,13,12,10,35,0.7142857142857143
Just Dance 2015,60,20,32,112,0.7142857142857143
Mario Party 6,54,6,24,84,0.7142857142857143
The Sims 3: Pets,35,20,22,77,0.7142857142857143
Mario & Sonic at the London 2012 Olympic Games,73,17,36,126,0.7142857142857143
Woodle Tree Adventures,24,21,18,63,0.7142857142857143
Mario Tennis Aces,325,115,176,616,0.7142857142857143
The Death,23,7,12,42,0.7142857142857143
Tales of Monkey Island Chapter 4: The Trial and Execution of Guybrush Threepwood,20,5,10,35,0.7142857142857143
Sonic and the Black Knight,133,32,66,231,0.7142857142857143
Super Mario All-Stars,64,11,30,105,0.7142857142857143
Painkiller: Redemption,11,24,14,49,0.7142857142857143
The Guy Game,9,21,12,42,0.7142857142857143
Rise & Shine,32,18,20,70,0.7142857142857143
Boom Blox,24,11,14,49,0.7142857142857143
NASCAR: The Game 2013,14,21,14,49,0.7142857142857143
Dragon Fantasy: The Black Tome of Ice,19,11,12,42,0.7142857142857143
The Sims: House Party,19,6,10,35,0.7142857142857143
WRC 5,39,51,36,126,0.7142857142857143
Toybox Turbos,25,15,16,56,0.7142857142857143
Prodeus,55,10,26,91,0.7142857142857143
Effie,17,8,10,35,0.7142857142857143
Stray Gods: The Roleplaying Musical,34,6,16,56,0.7142857142857143
Jurassic World Evolution 2,195,45,96,336,0.7142857142857143
Not Tonight: Take Back Control Edition,18,12,12,42,0.7142857142857143
Call of Juarez: Bound in Blood,313,29,137,479,0.7139874739039666
Grand Theft Auto IV,286,188,190,664,0.713855421686747
Trine,418,18,175,611,0.7135842880523732
Penumbra: Overture,128,14,57,199,0.7135678391959799
La Pucelle: Tactics,79,38,47,164,0.7134146341463414
Jusant,101,6,43,150,0.7133333333333334
Neverending Nightmares,70,27,39,136,0.7132352941176471
Escape from Monkey Island,74,13,35,122,0.7131147540983607
Pac-Man Championship Edition 2,45,12,23,80,0.7125
Magicka,421,62,195,678,0.7123893805309734
Stacking,138,13,61,212,0.7122641509433962
Cold Fear,81,8,36,125,0.712
Jamestown: Legend of the Lost Colony,109,22,53,184,0.7119565217391305
MotorStorm,190,67,104,361,0.7119113573407202
Indiana Jones and the Staff of Kings,31,11,17,59,0.711864406779661
LEGO Marvel Super Heroes: Universe in Peril,20,22,17,59,0.711864406779661
Kung Fury: Street Rage,34,8,17,59,0.711864406779661
Sniper Elite V2 Remastered,47,37,34,118,0.711864406779661
Enslaved: Odyssey to the West - Pigsy's Perfect 10,28,9,15,52,0.7115384615384616
WWE 2K15,131,202,135,468,0.7115384615384616
Ms. 'Splosion Man,29,8,15,52,0.7115384615384616
Cognition: An Erica Reed Thriller Episode 1 - The Hangman,28,9,15,52,0.7115384615384616
Stronghold: Crusader II,102,78,73,253,0.7114624505928854
Borderlands 2: Mr. Torgue's Campaign of Carnage,126,17,58,201,0.7114427860696517
Aion,102,41,58,201,0.7114427860696517
Sonic Heroes,383,63,181,627,0.7113237639553429
NHL 14,85,48,54,187,0.7112299465240641
Descent 3,27,5,13,45,0.7111111111111111
Batman: Arkham Knight - GCPD Lockdown,18,14,13,45,0.7111111111111111
Need for Speed: Nitro,25,7,13,45,0.7111111111111111
World's End Club,18,14,13,45,0.7111111111111111
Teenage Mutant Ninja Turtles (2003),53,11,26,90,0.7111111111111111
STASIS,81,15,39,135,0.7111111111111111
Heavenly Sword,181,38,89,308,0.711038961038961
Maneater,296,117,168,581,0.7108433734939759
Shinobi (2011),22,5,11,38,0.7105263157894737
Dogfight 1942,14,13,11,38,0.7105263157894737
The Temple of Elemental Evil,49,5,22,76,0.7105263157894737
Lydia,18,9,11,38,0.7105263157894737
Disney/Pixar Cars 2,60,21,33,114,0.7105263157894737
Really Big Sky,11,16,11,38,0.7105263157894737
Fieldrunners,17,10,11,38,0.7105263157894737
Cloudberry Kingdom,58,18,31,107,0.7102803738317757
Dead Space 3,1338,703,833,2874,0.710160055671538
Mini Metro,111,9,49,169,0.7100591715976331
S.T.A.L.K.E.R.: Clear Sky,448,76,214,738,0.7100271002710027
Aragami 2,31,40,29,100,0.71
Inazuma Eleven Strikers,21,1,9,31,0.7096774193548387
My Pokemon Ranch,7,15,9,31,0.7096774193548387
Mafia II: Joe's Adventures,70,40,45,155,0.7096774193548387
Pure Futbol,21,1,9,31,0.7096774193548387
Vikings: Wolves of Midgard,77,33,45,155,0.7096774193548387
King's Quest Chapter 2: Rubble Without a Cause,24,20,18,62,0.7096774193548387
Alien Breed,10,12,9,31,0.7096774193548387
Croc 2,17,5,9,31,0.7096774193548387
FRACT OSC,14,8,9,31,0.7096774193548387
Cross Edge,12,10,9,31,0.7096774193548387
80's Overdrive,17,5,9,31,0.7096774193548387
Hell Yeah! Wrath of the Dead Rabbit,86,19,43,148,0.7094594594594594
The Guild 2: Renaissance,36,3,16,55,0.7090909090909091
Fahrenheit: Indigo Prophecy Remastered,201,33,96,330,0.7090909090909091
Dungeons,24,54,32,110,0.7090909090909091
Batman: The Enemy Within - Episode 2: The Pact,24,15,16,55,0.7090909090909091
Dead Island: Riptide - Definitive Edition,25,14,16,55,0.7090909090909091
SpongeBob SquarePants: Revenge of the Flying Dutchman,19,20,16,55,0.7090909090909091
Sid Meier's Civilization IV: Colonization,100,34,55,189,0.708994708994709
Trove,60,35,39,134,0.7089552238805971
Sonic Advance 3,51,5,23,79,0.7088607594936709
Killzone: Shadow Fall - Intercept,41,15,23,79,0.7088607594936709
Telling Lies,59,53,46,158,0.7088607594936709
Forager,90,22,46,158,0.7088607594936709
Stories: The Path of Destinies,162,23,76,261,0.7088122605363985
Borderlands: The Secret Armory of General Knoxx,106,23,53,182,0.7087912087912088
Scott Pilgrim vs. the World: The Game - Complete Edition,54,19,30,103,0.7087378640776699
Teenage Zombies: Invasion of the Alien Brain Thingys,67,6,30,103,0.7087378640776699
The Amazing Spider-Man 2,270,318,242,830,0.708433734939759
PGA Tour 2K23,17,17,14,48,0.7083333333333334
Dragon Quest II,27,7,14,48,0.7083333333333334
The Blackwell Legacy,61,7,28,96,0.7083333333333334
Arcadegeddon,37,14,21,72,0.7083333333333334
WRC 6: World Rally Championship,28,40,28,96,0.7083333333333334
Dragon Age II: The Exiled Prince,17,46,26,89,0.7078651685393258
Angry Birds,118,71,78,267,0.7078651685393258
Dante's Inferno,394,37,178,609,0.7077175697865353
I Am Bread TV,32,60,38,130,0.7076923076923077
Mario Party: The Top 100,47,28,31,106,0.7075471698113207
Nation Red,48,10,24,82,0.7073170731707317
Cozy Grove,21,8,12,41,0.7073170731707317
EyePet: Move Edition,9,20,12,41,0.7073170731707317
Tom Clancy's Splinter Cell Classic Trilogy HD,23,6,12,41,0.7073170731707317
Borderlands 2: Headhunter Pack 1 - TK Baha's Bloody Harvest,15,14,12,41,0.7073170731707317
Pokemon Battle Trozei,24,5,12,41,0.7073170731707317
Hearthstone: Heroes of Warcraft - Goblins Vs. Gnomes,52,35,36,123,0.7073170731707317
Crysis 2,1839,451,948,3238,0.7072266831377394
Deliver Us The Moon,206,45,104,355,0.7070422535211267
Mario Golf,38,3,17,58,0.7068965517241379
Bionicle Heroes,58,19,32,109,0.7064220183486238
The Legend of Spyro: A New Beginning,59,30,37,126,0.7063492063492064
Mario Strikers Charged,79,34,47,160,0.70625
UFC Undisputed 2010,53,19,30,102,0.7058823529411765
A Virus Named TOM,24,24,20,68,0.7058823529411765
Project Gotham Racing 4,85,59,60,204,0.7058823529411765
Yu-Gi-Oh! Millennium Duels,17,7,10,34,0.7058823529411765
The Disney Afternoon Collection,15,9,10,34,0.7058823529411765
Yu-Gi-Oh! Zexal: World Duel Carnival,14,10,10,34,0.7058823529411765
Shadowgate (2014),27,9,15,51,0.7058823529411765
Yu-Gi-Oh! The Eternal Duelist Soul,16,8,10,34,0.7058823529411765
Pac-Man World 2,64,8,30,102,0.7058823529411765
ANNO: Mutationem,37,11,20,68,0.7058823529411765
Hidden & Dangerous,21,3,10,34,0.7058823529411765
Ragnarok Odyssey ACE,26,10,15,51,0.7058823529411765
The Baconing,20,16,15,51,0.7058823529411765
Moon Hunters,26,10,15,51,0.7058823529411765
Hexen II,23,1,10,34,0.7058823529411765
Mario Golf: Super Rush,89,98,78,265,0.7056603773584905
Crash Nitro Kart,128,11,58,197,0.7055837563451777
Somerville,53,74,53,180,0.7055555555555556
Batman: The Telltale Series - Episode 2: Children of Arkham,75,28,43,146,0.7054794520547946
Surviving Mars,143,51,81,275,0.7054545454545454
de Blob 2,74,17,38,129,0.7054263565891473
Battlefield 4: Naval Strike,38,29,28,95,0.7052631578947368
Full Throttle Remastered,96,26,51,173,0.7052023121387283
ABZU,679,115,332,1126,0.7051509769094139
Sacred,142,11,64,217,0.7050691244239631
Surgeon Simulator 2013,132,107,100,339,0.7050147492625368
King Oddball,21,22,18,61,0.7049180327868853
Game of Thrones: Episode Six - The Ice Dragon,98,38,57,193,0.7046632124352331
The Adventures of Shuggy,28,3,13,44,0.7045454545454546
Shardlight,23,8,13,44,0.7045454545454546
MechWarrior 4: Vengeance,26,5,13,44,0.7045454545454546
Summoner,28,3,13,44,0.7045454545454546
Stealth Inc 2: A Game of Clones,65,16,34,115,0.7043478260869566
Shift 2: Unleashed,243,138,160,541,0.7042513863216266
Payday: The Heist,388,64,190,642,0.7040498442367601
All Zombies Must Die!,17,21,16,54,0.7037037037037037
Mighty Switch Force! 2,30,8,16,54,0.7037037037037037
Edge Of Eternity,35,22,24,81,0.7037037037037037
Saw II: Flesh & Blood,19,19,16,54,0.7037037037037037
Fistful of Frags,36,2,16,54,0.7037037037037037
"#IDARB",48,16,27,91,0.7032967032967034
Styx: Master of Shadows,273,92,154,519,0.7032755298651252
Borderlands: Mad Moxxi's Underdome Riot,25,65,38,128,0.703125
Runaway: The Dream of the Turtle,40,5,19,64,0.703125
Grow Home,167,65,98,330,0.703030303030303
Assassin's Creed Syndicate: The Dreadful Crimes,22,4,11,37,0.7027027027027027
TY the Tasmanian Tiger,49,3,22,74,0.7027027027027027
Atelier Iris: Eternal Mana,21,5,11,37,0.7027027027027027
Nimbus,25,1,11,37,0.7027027027027027
Punch Club,122,34,66,222,0.7027027027027027
Cloudbuilt,23,3,11,37,0.7027027027027027
Mighty Gunvolt,21,5,11,37,0.7027027027027027
SpongeBob SquarePants featuring Nicktoons: Globs of Doom,16,10,11,37,0.7027027027027027
Assassin's Creed Rogue,992,277,537,1806,0.7026578073089701
Tomb Raider: Legend,382,22,171,575,0.7026086956521739
Borderlands: The Pre-Sequel,748,317,451,1516,0.7025065963060686
Evil Genius 2: World Domination,30,29,25,84,0.7023809523809523
DreamWorks Kung Fu Panda: Showdown of Legendary Legends,23,36,25,84,0.7023809523809523
Where the Water Tastes Like Wine,15,18,14,47,0.7021276595744681
Defiance 2050,10,23,14,47,0.7021276595744681
Phineas and Ferb: Across the 2nd Dimension,27,6,14,47,0.7021276595744681
Marvel's Guardians of the Galaxy - Episode 4: Who Needs You,25,8,14,47,0.7021276595744681
Teenage Mutant Ninja Turtles: Turtles in Time Re-Shelled,19,14,14,47,0.7021276595744681
PixelJunk Shooter Ultimate,117,29,62,208,0.7019230769230769
Halo: Spartan Assault,137,195,141,473,0.7019027484143763
Act of Aggression,71,16,37,124,0.7016129032258065
Assassin's Creed: Revelations,1984,266,957,3207,0.7015902712815716
Last Stop (2021),72,29,43,144,0.7013888888888888
X-Men: Destiny,36,65,43,144,0.7013888888888888
Enemy Territory: Quake Wars,54,7,26,87,0.7011494252873564
GoNNER,47,21,29,97,0.7010309278350515
Pumpkin Jack,59,9,29,97,0.7010309278350515
Battlefield 4: China Rising,66,51,50,167,0.7005988023952096
Super Mario Party,367,115,206,688,0.7005813953488372
RAGE 2,693,561,536,1790,0.7005586592178771
Tom Clancy's Ghost Recon: Future Soldier,438,233,287,958,0.7004175365344467
Arcania: Gothic 4,90,300,167,557,0.7001795332136446
Battlefield 4: Second Assault,37,26,27,90,0.7
Marvel Super Hero Squad,12,9,9,30,0.7
Big Brain Academy: Brain vs. Brain,20,1,9,30,0.7
Smart as...,28,7,15,50,0.7
Wonderbook: Book of Spells,19,9,12,40,0.7
Star Trek: Elite Force II,27,1,12,40,0.7
Command & Conquer: Renegade,66,11,33,110,0.7
Ground Control,24,4,12,40,0.7
Crazy Machines 3,15,6,9,30,0.7
Escape Goat 2,17,4,9,30,0.7
Dynasty Warriors 5,36,13,21,70,0.7
Pummel Party,18,3,9,30,0.7
Druidstone: The Secret of the Menhir Forest,17,4,9,30,0.7
Cities XL,9,12,9,30,0.7
Her Majesty's SPIFFING,14,7,9,30,0.7
Doki-Doki Universe,62,36,42,140,0.7
Poi,15,6,9,30,0.7
MXGP2: The Official Motocross Videogame,18,10,12,40,0.7
Deep Sky Derelicts,20,8,12,40,0.7
Little Dragons Cafe,17,11,12,40,0.7
Tiny Hands Adventure,13,8,9,30,0.7
Heretic II,17,4,9,30,0.7
GRID Legends,110,65,75,250,0.7
Vigil: The Longest Night,31,11,18,60,0.7
Summer in Mara,41,8,21,70,0.7
From Dust,179,177,153,509,0.6994106090373281
DC Universe Online,310,132,190,632,0.6993670886075949
PlayStation VR WORLDS,70,23,40,133,0.6992481203007519
Ben 10: Protector of Earth,74,5,34,113,0.6991150442477876
CHUCHEL,49,23,31,103,0.6990291262135923
Wolfenstein,380,38,180,598,0.6989966555183946
LEGO Marvel's Avengers,195,58,109,362,0.6988950276243094
Zuma's Revenge!,50,8,25,83,0.6987951807228916
The Way Remastered,42,16,25,83,0.6987951807228916
forma.8,31,20,22,73,0.6986301369863014
Crush (2007),73,29,44,146,0.6986301369863014
Star Wars: Bounty Hunter,47,4,22,73,0.6986301369863014
LEGO Marvel Super Heroes 2,140,50,82,272,0.6985294117647058
Dead Rising 4: Frank's Big Package,72,23,41,136,0.6985294117647058
Quake III: Team Arena,72,23,41,136,0.6985294117647058
Age of Empires Online,65,67,57,189,0.6984126984126984
Ultratron,34,10,19,63,0.6984126984126984
The Walking Dead: 400 Days,458,63,225,746,0.6983914209115282
Kao the Kangaroo Round 2,55,19,32,106,0.6981132075471698
Dragon Ball Z: Shin Budokai,27,10,16,53,0.6981132075471698
Flynn: Son of Crimson,30,7,16,53,0.6981132075471698
The Final Station,85,19,45,149,0.697986577181208
Costume Quest 2,72,25,42,139,0.697841726618705
Dragon Ball Z: Ultimate Tenkaichi,57,70,55,182,0.6978021978021978
Decay of Logos,16,14,13,43,0.6976744186046512
Valley,76,14,39,129,0.6976744186046512
NASCAR Heat 4,19,11,13,43,0.6976744186046512
Alien Rage,126,47,75,248,0.6975806451612904
Yoshi's New Island,81,62,62,205,0.697560975609756
Among Us,249,90,147,486,0.6975308641975309
Shin Megami Tensei: Devil Summoner - Raidou Kuzunoha vs. the Soulless Army,38,15,23,76,0.6973684210526315
Feel the Magic: XY/XX,55,21,33,109,0.6972477064220184
Arcade Paradise,14,9,10,33,0.696969696969697
NHL 2001,34,12,20,66,0.696969696969697
Fire Emblem: Shadow Dragon & the Blade of Light,21,2,10,33,0.696969696969697
Madden NFL 09,25,21,20,66,0.696969696969697
Wave Race: Blue Storm,20,3,10,33,0.696969696969697
Samba de Amigo,22,1,10,33,0.696969696969697
Medal of Honor: European Assault,97,34,57,188,0.6968085106382979
Bound (2016),81,27,47,155,0.6967741935483871
Renegade Ops,90,18,47,155,0.6967741935483871
Home (2012),51,34,37,122,0.6967213114754098
Neon Chrome,46,16,27,89,0.6966292134831461
Bloodroots,44,18,27,89,0.6966292134831461
Devil May Cry 2,225,156,166,547,0.696526508226691
Saint Seiya: Brave Soldiers,31,8,17,56,0.6964285714285714
Mat Hoffman's Pro BMX,30,9,17,56,0.6964285714285714
Half-Minute Hero: Super Mega Neo Climax Ultimate Boy,34,5,17,56,0.6964285714285714
Batman: Arkham City - Nightwing Bundle Pack,33,6,17,56,0.6964285714285714
Weird West,97,29,55,181,0.6961325966850829
Prey (2006),276,26,132,434,0.695852534562212
Saint Seiya: Sanctuary Battle,29,3,14,46,0.6956521739130435
The Walking Dead: The Telltale Series - A New Frontier Episode 3: Above the Law,50,30,35,115,0.6956521739130435
Marlow Briggs and the Mask of Death,60,20,35,115,0.6956521739130435
Voice of Cards: The Isle Dragon Roars,41,7,21,69,0.6956521739130435
Nidhogg,109,44,67,220,0.6954545454545454
Kholat,92,45,60,197,0.6954314720812182
Gran Turismo 5 Prologue,32,25,25,82,0.6951219512195121
Tony Hawk's American Wasteland,89,9,43,141,0.6950354609929078
Futuridium EP,23,18,18,59,0.6949152542372882
Big Mutha Truckers 2,145,3,65,213,0.6948356807511737
Saints Row (2006),119,13,58,190,0.6947368421052632
The Flame in the Flood,83,42,55,180,0.6944444444444444
The Seven Deadly Sins: Knights of Britannia,14,11,11,36,0.6944444444444444
Dynasty Warriors: Gundam 2,18,7,11,36,0.6944444444444444
Spiral Knights,118,32,66,216,0.6944444444444444
Mario Sports Mix,47,3,22,72,0.6944444444444444
Colin McRae Rally 3,23,2,11,36,0.6944444444444444
NBA Jam (2010),43,7,22,72,0.6944444444444444
Lost Planet 3,203,147,154,504,0.6944444444444444
ECHO (2017),36,14,22,72,0.6944444444444444
The Spectrum Retreat,17,8,11,36,0.6944444444444444
INSOMNIA: The Ark,16,9,11,36,0.6944444444444444
Test Drive Unlimited 2,197,121,140,458,0.6943231441048034
Killzone,145,25,75,245,0.6938775510204082
Port Royale 2,33,1,15,49,0.6938775510204082
DISTRAINT,59,9,30,98,0.6938775510204082
Mario Party 4,71,6,34,111,0.6936936936936937
Army of Two: The Devil's Cartel,163,77,106,346,0.6936416184971098
Killzone: Shadow Fall,1337,490,807,2634,0.693621867881549
The Park,47,39,38,124,0.6935483870967742
Sea of Solitude,90,57,65,212,0.6933962264150944
Super Kirby Clash,44,8,23,75,0.6933333333333334
Victor Vran,86,11,43,140,0.6928571428571428
WWE SmackDown vs. Raw 2011,125,10,60,195,0.6923076923076923
Mario Party 7,59,4,28,91,0.6923076923076923
Assassin's Creed Syndicate: Jack the Ripper,88,20,48,156,0.6923076923076923
Carrion,259,20,124,403,0.6923076923076923
The Jackbox Party Pack 4,23,4,12,39,0.6923076923076923
Nom Nom Galaxy,25,11,16,52,0.6923076923076923
Roundabout,18,9,12,39,0.6923076923076923
Crying Suns,41,4,20,65,0.6923076923076923
Fight Night Round 3,70,11,36,117,0.6923076923076923
Coffin Dodgers,15,21,16,52,0.6923076923076923
Transference,23,13,16,52,0.6923076923076923
Degrees of Separation,20,7,12,39,0.6923076923076923
Tales of Monkey Island Chapter 3: Lair of the Leviathan,23,4,12,39,0.6923076923076923
Battlefield: Bad Company,237,15,112,364,0.6923076923076923
Need for Speed: ProStreet,281,81,161,523,0.6921606118546845
Apotheon,273,48,143,464,0.6918103448275862
Worms 2: Armageddon,155,42,88,285,0.6912280701754386
Sniper: Ghost Warrior 2,241,200,197,638,0.6912225705329154
Yakuza 4 Remastered,82,12,42,136,0.6911764705882353
No Time to Explain,29,18,21,68,0.6911764705882353
Everybody's Gone to the Rapture,339,182,233,754,0.6909814323607427
Pokemon Ranger: Guardian Signs,37,1,17,55,0.6909090909090909
Sherlock Holmes: The Devil's Daughter,222,82,136,440,0.6909090909090909
Alien Swarm (2010),218,12,103,333,0.6906906906906907
Amnesia: Justine,23,6,13,42,0.6904761904761905
Dead Rising 2: Case Zero,51,7,26,84,0.6904761904761905
MX vs. ATV Alive,21,8,13,42,0.6904761904761905
Madden NFL 07,37,12,22,71,0.6901408450704225
Rabbids Go Home,47,2,22,71,0.6901408450704225
Tower Wars (2012),27,13,18,58,0.6896551724137931
Epistory - Typing Chronicles,36,4,18,58,0.6896551724137931
Stubbs the Zombie in Rebel Without a Pulse,54,6,27,87,0.6896551724137931
Oxenfree II: Lost Signals,33,7,18,58,0.6896551724137931
Cities in Motion 2,87,24,50,161,0.6894409937888198
The Awesome Adventures of Captain Spirit,191,42,105,338,0.6893491124260355
Lego Indiana Jones: The Original Adventures,206,20,102,328,0.6890243902439024
Tony Hawk's Pro Skater HD,59,54,51,164,0.6890243902439024
Dead Nation,428,108,242,778,0.6889460154241646
Call of Duty: Finest Hour,223,76,135,434,0.6889400921658986
Eschalon: Book I,26,5,14,45,0.6888888888888889
Dragon Quest,36,6,19,61,0.6885245901639344
Gears of War: Judgment,378,305,309,992,0.688508064516129
Rune,46,7,24,77,0.6883116883116883
Eufloria,55,9,29,93,0.6881720430107527
Singularity,397,35,196,628,0.6878980891719745
Assassin's Creed III Remastered,158,168,148,474,0.6877637130801688
Plague Inc: Evolved,140,23,74,237,0.6877637130801688
Foul Play,23,21,20,64,0.6875
DeadCore,22,11,15,48,0.6875
God Mode,81,40,55,176,0.6875
FIFA Manager 12,6,16,10,32,0.6875
Running with Rifles,18,4,10,32,0.6875
Stronghold Legends,38,6,20,64,0.6875
SEUM: Speedrunners from Hell,18,4,10,32,0.6875
Slipstream,19,3,10,32,0.6875
Terminator: Resistance - Annihilation Line,19,3,10,32,0.6875
Wheelman,88,22,50,160,0.6875
Nickelodeon Teenage Mutant Ninja Turtles,11,11,10,32,0.6875
Quest of Dungeons,18,4,10,32,0.6875
A Valley Without Wind 2,16,6,10,32,0.6875
The Guided Fate Paradox,38,6,20,64,0.6875
Marvel's Spider-Man: Silver Lining,92,18,50,160,0.6875
Marvel vs. Capcom 3: Fate of Two Worlds,192,43,107,342,0.6871345029239766
Xbox Fitness,32,25,26,83,0.6867469879518072
Marvel's Spider-Man: The Heist,124,36,73,233,0.6866952789699571
Bright Memory: Infinite,80,23,47,150,0.6866666666666666
Battlerite,74,18,42,134,0.6865671641791045
Entwined,119,43,74,236,0.6864406779661016
Zoo Tycoon (2001),46,13,27,86,0.686046511627907
Masquerada: Songs and Shadows,22,2,11,35,0.6857142857142857
Cabela's Big Game Hunter: Pro Hunts,19,5,11,35,0.6857142857142857
Goosebumps: The Game,15,9,11,35,0.6857142857142857
Five Dates,16,8,11,35,0.6857142857142857
Reigns: Her Majesty,19,5,11,35,0.6857142857142857
Disney/Pixar Cars Race-O-Rama,55,17,33,105,0.6857142857142857
Watchmen: The End Is Nigh Part 2,11,13,11,35,0.6857142857142857
Kill It With Fire,17,7,11,35,0.6857142857142857
Little Inferno,264,48,143,455,0.6857142857142857
Heavy Fire: Afghanistan,6,18,11,35,0.6857142857142857
Prominence Poker,17,7,11,35,0.6857142857142857
Anno 1404 Gold Edition,20,4,11,35,0.6857142857142857
Necrobarista,15,9,11,35,0.6857142857142857
Red Faction: Guerrilla,330,43,171,544,0.6856617647058824
Wii Sports,307,13,147,467,0.6852248394004282
Teleglitch: Die More Edition,28,9,17,54,0.6851851851851852
9 Monkeys of Shaolin,29,8,17,54,0.6851851851851852
Slender,66,21,40,127,0.6850393700787402
Unpacking,127,23,69,219,0.684931506849315
Cities XL Platinum,27,23,23,73,0.684931506849315
Resident Evil 5: Desperate Escape,37,13,23,73,0.684931506849315
Hoa,44,6,23,73,0.684931506849315
Journey to the Savage Planet,131,45,81,257,0.6848249027237354
Beat Cop,71,18,41,130,0.6846153846153846
Hammerwatch,75,14,41,130,0.6846153846153846
Resident Evil 5,1758,379,985,3122,0.6844971172325433
Hard Reset,211,45,118,374,0.6844919786096256
Hard Corps: Uprising,33,6,18,57,0.6842105263157895
FIFA Soccer 2005,51,14,30,95,0.6842105263157895
Slender: The Arrival,188,111,138,437,0.6842105263157895
GUNS UP!,23,16,18,57,0.6842105263157895
Bionic Commando: Rearmed,57,21,36,114,0.6842105263157895
Dragon Ball: Raging Blast 2,88,16,48,152,0.6842105263157895
Here They Lie,57,21,36,114,0.6842105263157895
Fat Princess Adventures,30,9,18,57,0.6842105263157895
LEGO Harry Potter: Years 1-4,227,35,121,383,0.6840731070496083
Hitman: Contracts,223,13,109,345,0.6840579710144927
Deadlight,463,91,256,810,0.6839506172839506
Tom Clancy's Rainbow Six: Vegas 2,195,17,98,310,0.6838709677419355
Last Day of June,82,24,49,155,0.6838709677419355
Road Redemption,36,31,31,98,0.6836734693877551
The Walking Dead: Michonne - Episode 3: What We Deserve,55,12,31,98,0.6836734693877551
Midnight Fight Express,52,15,31,98,0.6836734693877551
Octodad: Dadliest Catch,236,60,137,433,0.6836027713625866
Atlas Fallen,59,36,44,139,0.6834532374100719
DarkStar One,31,10,19,60,0.6833333333333333
10 Second Ninja X,22,19,19,60,0.6833333333333333
Broken Age,212,62,127,401,0.683291770573566
F1 Race Stars,65,45,51,161,0.6832298136645962
Battlefield 2142,105,20,58,183,0.6830601092896175
Iron Front: Liberation 1944,96,16,52,164,0.6829268292682927
Mario & Sonic at the Olympic Winter Games,78,6,39,123,0.6829268292682927
Conflict: Denied Ops,8,20,13,41,0.6829268292682927
World War II: Prisoner of War,22,6,13,41,0.6829268292682927
Cooking Simulator,14,14,13,41,0.6829268292682927
Opoona,65,6,33,104,0.6826923076923077
Amnesia: A Machine for Pigs,368,303,312,983,0.6826042726347915
Master Reboot,26,17,20,63,0.6825396825396826
Citizens of Earth,140,32,80,252,0.6825396825396826
GRID 2,409,281,321,1011,0.6824925816023739
Need for Speed: The Run,445,251,324,1020,0.6823529411764706
Just Cause 3,888,480,637,2005,0.6822942643391521
DiRT Showdown,127,92,102,321,0.6822429906542056
Tomb Raider: Underworld,334,46,177,557,0.6822262118491921
The Getaway,38,7,21,66,0.6818181818181818
Chaos Legion,33,12,21,66,0.6818181818181818
Lost Words: Beyond the Page,42,3,21,66,0.6818181818181818
Martha is Dead,92,28,56,176,0.6818181818181818
Star Wars Episode III: Revenge of the Sith,99,6,49,154,0.6818181818181818
Exit the Gungeon,23,7,14,44,0.6818181818181818
Trials Fusion,335,100,203,638,0.6818181818181818
LEGO The Incredibles,49,26,35,110,0.6818181818181818
Shrek 2,96,43,65,204,0.6813725490196079
Disney Epic Mickey,101,23,58,182,0.6813186813186813
TMNT,76,33,51,160,0.68125
LEGO Jurassic World,219,50,126,395,0.6810126582278481
Peggle 2,294,73,172,539,0.6808905380333952
Devil May Cry 4: Special Edition,71,25,45,141,0.6808510638297872
Sagebrush,29,3,15,47,0.6808510638297872
Sid Meier's Railroads!,24,8,15,47,0.6808510638297872
LEGO Star Wars III: The Clone Wars,211,32,114,357,0.680672268907563
Strange Brigade,68,30,46,144,0.6805555555555556
Hohokum,66,32,46,144,0.6805555555555556
Tom Clancy's Splinter Cell: Double Agent,240,56,139,435,0.6804597701149425
Grand Theft Auto 2,184,16,94,294,0.6802721088435374
The Dark Crystal: Age of Resistance Tactics,20,14,16,50,0.68
ZHEROS,13,21,16,50,0.68
The Legend of Zelda: Four Swords Adventures,59,9,32,100,0.68
Neverwinter Nights: Shadows of Undrentide,62,6,32,100,0.68
E.Y.E: Divine Cybermancy,89,38,60,187,0.679144385026738
Virginia,103,115,103,321,0.6791277258566978
J-Stars Victory Vs+,79,31,52,162,0.6790123456790124
Tom Clancy's Splinter Cell: Conviction,523,113,301,937,0.6787620064034151
Quantum Conundrum,153,35,89,277,0.6787003610108303
Townscaper,41,16,27,84,0.6785714285714286
Sonic Battle,34,4,18,56,0.6785714285714286
Tricky Towers,75,22,46,143,0.6783216783216783
Fallout: New Vegas - Dead Money,158,95,120,373,0.67828418230563
Mario & Sonic at the Sochi 2014 Olympic Winter Games,39,20,28,87,0.6781609195402298
Alex Kidd in Miracle World DX,40,19,28,87,0.6781609195402298
Nine Parchments,44,15,28,87,0.6781609195402298
The Lord of the Rings: War in the North,347,87,206,640,0.678125
BioShock Infinite: Clash in the Clouds,113,47,76,236,0.6779661016949152
Ratchet & Clank: Size Matters,160,21,86,267,0.6779026217228464
Gravel,46,15,29,90,0.6777777777777778
Adventure Time: Pirates of the Enchiridion,35,26,29,90,0.6777777777777778
Treasures of Montezuma Blitz,12,9,10,31,0.6774193548387096
Death Squared,36,6,20,62,0.6774193548387096
Driver: Renegade,10,11,10,31,0.6774193548387096
"Warhammer 40,000: Sanctus Reach",16,5,10,31,0.6774193548387096
Magic: The Gathering Online,7,14,10,31,0.6774193548387096
Kingdom (2015),56,7,30,93,0.6774193548387096
Blood and Bacon,17,4,10,31,0.6774193548387096
Star Wars: Racer Revenge,16,5,10,31,0.6774193548387096
POST VOID,20,1,10,31,0.6774193548387096
Sword Art Online Re: Hollow Fragment,50,15,31,96,0.6770833333333334
Sonic the Hedgehog 4: Episode II,155,63,104,322,0.6770186335403726
Black Mirror II: Reigning Evil,39,5,21,65,0.676923076923077
Worms Clan Wars,33,11,21,65,0.676923076923077
FlatOut,116,16,63,195,0.676923076923077
Star Wars: Dark Forces,41,3,21,65,0.676923076923077
Might & Magic: Heroes VI,261,206,223,690,0.6768115942028986
El Shaddai: Ascension of the Metatron,56,11,32,99,0.6767676767676768
Shelter,52,15,32,99,0.6767676767676768
Hue,113,21,64,198,0.6767676767676768
King's Bounty: Dark Side,44,23,32,99,0.6767676767676768
Ice Station Z,16,7,11,34,0.6764705882352942
Icewind Dale: Heart of Winter,43,3,22,68,0.6764705882352942
Bomber Crew,39,7,22,68,0.6764705882352942
Critical Mass (2011),16,7,11,34,0.6764705882352942
NASCAR Heat 2,12,11,11,34,0.6764705882352942
The Yawhg,21,2,11,34,0.6764705882352942
Anomaly Defenders,16,7,11,34,0.6764705882352942
Convoy: A Tactical Roguelike,10,13,11,34,0.6764705882352942
The Mean Greens: Plastic Warfare,19,4,11,34,0.6764705882352942
The Cursed Crusade,29,42,34,105,0.6761904761904762
Alone in the Dark (2008),87,103,91,281,0.6761565836298933
Blade Kitten,37,11,23,71,0.676056338028169
The Sims 2: Castaway,36,12,23,71,0.676056338028169
Wings of Prey,38,10,23,71,0.676056338028169
Disc Jam,47,26,35,108,0.6759259259259259
Thief Simulator,46,29,36,111,0.6756756756756757
Guild of Dungeoneering,26,24,24,74,0.6756756756756757
art of rally,55,20,36,111,0.6756756756756757
Eliza,17,8,12,37,0.6756756756756757
Assassin's Creed Valhalla: Wrath of the Druids,79,71,72,222,0.6756756756756757
The Amazing Spider-Man,412,115,253,780,0.6756410256410257
Yakuza,58,19,37,114,0.6754385964912281
X-MEN ORIGINS: WOLVERINE,265,30,142,437,0.6750572082379863
Marvel's Guardians of the Galaxy - Episode 5: Don't Stop Believin',20,7,13,40,0.675
Tekken Hybrid,19,8,13,40,0.675
The Bouncer,22,7,14,43,0.6744186046511628
Torchlight,491,49,261,801,0.6741573033707865
Exo One,44,16,29,89,0.6741573033707865
Fallout 4: Automatron,123,123,119,365,0.673972602739726
"Warhammer 40,000: Armageddon",20,11,15,46,0.6739130434782609
Kick & Fennick,26,5,15,46,0.6739130434782609
Tom Clancy's Ghost Recon Advanced Warfighter 2,99,27,61,187,0.6737967914438503
The Walking Dead: Michonne - Episode 2: Give No Shelter,61,34,46,141,0.6737588652482269
DiRT 3,489,114,292,895,0.6737430167597765
Pokemon Mystery Dungeon: Gates to Infinity,79,49,62,190,0.6736842105263158
Godzilla: Unleashed - Double Smash,25,8,16,49,0.673469387755102
Delta Force: Land Warrior,27,6,16,49,0.673469387755102
PC Building Simulator,49,17,32,98,0.673469387755102
Catan (2003),26,7,16,49,0.673469387755102
Dungeon Siege III,176,259,211,646,0.673374613003096
Dragon Age II: Mark of the Assassin,70,64,65,199,0.6733668341708543
State of Mind,86,17,50,153,0.673202614379085
3on3 Freestyle,17,18,17,52,0.6730769230769231
Nosferatu: The Wrath of Malachi,30,5,17,52,0.6730769230769231
Move or Die,29,6,17,52,0.6730769230769231
Lost Planet 2,117,62,87,266,0.6729323308270677
The LEGO Movie Videogame,195,58,123,376,0.6728723404255319
Rogue Trooper,32,5,18,55,0.6727272727272727
Guts and Glory,17,20,18,55,0.6727272727272727
Sonic: Lost World,459,170,306,935,0.6727272727272727
Assassin's Creed Chronicles: India,66,86,74,226,0.672566371681416
Brothers in Arms: Earned in Blood,119,33,74,226,0.672566371681416
DiRT 5,188,196,187,571,0.6725043782837128
Juiced,31,8,19,58,0.6724137931034483
Space Run (2014),36,3,19,58,0.6724137931034483
Marvel's Spider-Man: The City That Never Sleeps,31,8,19,58,0.6724137931034483
Assassin's Creed III: Liberation,205,70,134,409,0.6723716381418093
Close to the Sun,55,64,58,177,0.672316384180791
Too Human,46,34,39,119,0.6722689075630253
Subsurface Circular,37,4,20,61,0.6721311475409836
Mana Spark,28,13,20,61,0.6721311475409836
Mario & Sonic at the Olympic Games Tokyo 2020,90,33,60,183,0.6721311475409836
Reus,133,33,81,247,0.6720647773279352
GoldenEye 007: Reloaded,74,51,61,186,0.6720430107526881
Mario Party: Star Rush,33,10,21,64,0.671875
Alliance of Valiant Arms,28,15,21,64,0.671875
Twin Mirror,68,61,63,192,0.671875
Wii Sports Club,65,23,43,131,0.6717557251908397
Three Fourths Home,25,20,22,67,0.6716417910447762
Blood Knights,24,23,23,70,0.6714285714285714
Drakensang: The Dark Eye,35,12,23,70,0.6714285714285714
Murasaki Baby,37,10,23,70,0.6714285714285714
The Deadly Tower of Monsters,80,18,48,146,0.6712328767123288
Beat Hazard,84,16,49,149,0.6711409395973155
ShellShock 2: Blood Trails,17,34,25,76,0.6710526315789473
Red Dead Revolver,141,16,77,234,0.6709401709401709
Picross S,42,11,26,79,0.6708860759493671
Lumo,33,20,26,79,0.6708860759493671
Pro Evolution Soccer 2012,194,75,132,401,0.6708229426433915
The Legend of Zelda: Four Swords Anniversary Edition,46,9,27,82,0.6707317073170732
One Piece: Burning Blood,86,24,54,164,0.6707317073170732
Duke Nukem: Manhattan Project,51,8,29,88,0.6704545454545454
Lunar: Dragon Song,59,2,30,91,0.6703296703296703
KickBeat,46,15,30,91,0.6703296703296703
Gran Turismo: The Real Driving Simulator,57,6,31,94,0.6702127659574468
Assassin's Creed III,2896,1075,1957,5928,0.6698717948717948
Halo Wars,452,126,285,863,0.6697566628041715
Spore,507,125,312,944,0.6694915254237288
Tropico 5,311,96,201,608,0.6694078947368421
Anomaly: Warzone Earth,118,25,71,214,0.6682242990654206
World of Warcraft: Cataclysm,482,390,433,1305,0.668199233716475
The Turing Test,136,43,89,268,0.667910447761194
Gauntlet (2014),159,50,104,313,0.6677316293929713
Fate of the World,23,3,13,39,0.6666666666666666
The Whispered World,48,14,31,93,0.6666666666666666
Dragon Ball Z: Ultimate Battle 22,13,21,17,51,0.6666666666666666
Pac-Man and the Ghostly Adventures,22,16,19,57,0.6666666666666666
GNOG,32,12,22,66,0.6666666666666666
Critter Crunch,14,8,11,33,0.6666666666666666
The Good Life,16,10,13,39,0.6666666666666666
A Kingdom for Keflings,17,5,11,33,0.6666666666666666
Mass Effect 3: Omega,113,61,87,261,0.6666666666666666
Kinect Sports: Season Two,25,7,16,48,0.6666666666666666
Tiger Woods PGA Tour 11,13,9,11,33,0.6666666666666666
Secret Files: Tunguska,41,7,24,72,0.6666666666666666
Mario Party DS,104,6,55,165,0.6666666666666666
Disney Castle of Illusion starring Mickey Mouse,118,30,74,222,0.6666666666666666
Back to Bed,20,18,19,57,0.6666666666666666
Demetrios - The BIG Cynical Adventure,21,5,13,39,0.6666666666666666
When The Past Was Around,21,5,13,39,0.6666666666666666
Sherlock Holmes vs. Jack the Ripper,44,10,27,81,0.6666666666666666
When Vikings Attack!,20,6,13,39,0.6666666666666666
Rango (2011),16,4,10,30,0.6666666666666666
Tropico 2: Pirate Cove,24,2,13,39,0.6666666666666666
Journey of a Roach,25,7,16,48,0.6666666666666666
Asterix & Obelix XXL 3: The Crystal Menhir,13,11,12,36,0.6666666666666666
Turnip Boy Commits Tax Evasion,47,11,29,87,0.6666666666666666
Gas Station Simulator,26,6,16,48,0.6666666666666666
Starship Troopers,10,10,10,30,0.6666666666666666
Ninety-Nine Nights,18,8,13,39,0.6666666666666666
Empire Earth II,46,6,26,78,0.6666666666666666
Metal Gear Rising: Revengeance - Jetstream,15,7,11,33,0.6666666666666666
Kingdoms and Castles,17,3,10,30,0.6666666666666666
Alien Swarm: Reactive Drop,21,1,11,33,0.6666666666666666
Q.U.B.E. Director's Cut,55,11,33,99,0.6666666666666666
The Thing,57,9,33,99,0.6666666666666666
Aegis Defenders,21,9,15,45,0.6666666666666666
Aperture Desk Job,27,1,14,42,0.6666666666666666
Two Point Campus,42,20,31,93,0.6666666666666666
Contraband Police,24,4,14,42,0.6666666666666666
Peaky Blinders: Mastermind,16,6,11,33,0.6666666666666666
Heroes of Might and Magic IV,219,24,122,365,0.6657534246575343
Dead Rising 2,402,135,270,807,0.6654275092936803
Crysis 3,1150,417,789,2356,0.6651103565365025
Tales of Vesperia,79,54,67,200,0.665
FIFA 07 Soccer,108,13,61,182,0.6648351648351648
Hidden Agenda,68,31,50,149,0.6644295302013423
Afterparty,65,28,47,140,0.6642857142857143
Stories Untold,62,17,40,119,0.6638655462184874
Warhammer: Chaosbane,57,91,75,223,0.6636771300448431
Stick Fight: The Game,68,5,37,110,0.6636363636363637
Disney/Pixar Cars 3: Driven to Win,48,21,35,104,0.6634615384615384
Mario Tennis: Ultra Smash,49,81,66,196,0.6632653061224489
NCAA Football 12,45,20,33,98,0.6632653061224489
BloodRayne,108,12,61,181,0.6629834254143646
Trine: Enchanted Edition,45,14,30,89,0.6629213483146067
One Piece: Pirate Warriors 2,48,5,27,80,0.6625
Dragon Ball: Raging Blast,40,13,27,80,0.6625
Magicka 2,95,52,75,222,0.6621621621621622
Realms of Ancient War,17,32,25,74,0.6621621621621622
Gal*Gun: Double Peace,79,15,48,142,0.6619718309859155
20XX,32,11,22,65,0.6615384615384615
Assassin's Creed III - The Betrayal,42,42,43,127,0.6614173228346457
Deceit,30,11,21,62,0.6612903225806451
Broken Sword: The Sleeping Dragon,64,14,40,118,0.6610169491525424
Eragon,24,13,19,56,0.6607142857142857
Age of History II,56,14,36,106,0.660377358490566
Beowulf: The Game,11,24,18,53,0.660377358490566
Nintendo DS,29,2,16,47,0.6595744680851063
DreamWorks Shrek the Third,31,31,32,94,0.6595744680851063
Dragon Ball Z: Extreme Butoden,24,7,16,47,0.6595744680851063
Pix the Cat,57,36,48,141,0.6595744680851063
EA Sports UFC,184,124,159,467,0.6595289079229122
Shadow the Hedgehog,177,123,155,455,0.6593406593406593
Painkiller: Battle out of Hell,53,7,31,91,0.6593406593406593
Fallout: New Vegas - Gun Runner's Arsenal,18,11,15,44,0.6590909090909091
WWE Raw,20,9,15,44,0.6590909090909091
Rayman Arena,26,3,15,44,0.6590909090909091
Night Watch,54,2,29,85,0.6588235294117647
Yesterday Origins,41,15,29,85,0.6588235294117647
Universe Sandbox,70,13,43,126,0.6587301587301587
Iron Man (2008),21,62,43,126,0.6587301587301587
The Bookwalker: Thief of Tales,25,2,14,41,0.6585365853658537
Worms Forts: Under Siege,23,4,14,41,0.6585365853658537
OMNO,64,17,42,123,0.6585365853658537
NBA Live 06,23,4,14,41,0.6585365853658537
Skylar & Plux: Adventure on Clover Island,19,8,14,41,0.6585365853658537
Need for Speed: Carbon,534,52,304,890,0.6584269662921348
Stick it to the Man!,246,64,161,471,0.6581740976645435
Afterfall: InSanity,49,51,52,152,0.6578947368421053
Sonic Shuffle,18,7,13,38,0.6578947368421053
Batman: The Enemy Within - Episode 3: The Fractured Mask,19,6,13,38,0.6578947368421053
Phoenix Wright: Ace Attorney - Justice for All,57,18,39,114,0.6578947368421053
Land of the Dead: Road to Fiddler's Green,14,11,13,38,0.6578947368421053
Akiba's Trip: Undead & Undressed,204,44,129,377,0.6578249336870027
The Elder Scrolls IV: Knights of the Nine,83,15,51,149,0.6577181208053692
Democracy 3,91,28,62,181,0.6574585635359116
Railway Empire,53,18,37,108,0.6574074074074074
Total War Battles: SHOGUN,16,7,12,35,0.6571428571428571
NORTH,12,11,12,35,0.6571428571428571
Star Wars: Episode I The Phantom Menace,18,5,12,35,0.6571428571428571
Cobra Kai: The Karate Kid Saga Continues,14,9,12,35,0.6571428571428571
Project Eden,19,4,12,35,0.6571428571428571
Team Fortress Classic,18,5,12,35,0.6571428571428571
Mario Party 10,170,92,137,399,0.656641604010025
inFamous: First Light,526,85,320,931,0.6562835660580022
Before the Echo,35,7,22,64,0.65625
FlatOut (2010),39,3,22,64,0.65625
Tenchu: Fatal Shadows,58,5,33,96,0.65625
Airline Tycoon 2,10,11,11,32,0.65625
Knight Squad,18,3,11,32,0.65625
Portal Knights,80,25,55,160,0.65625
Full House Poker,16,5,11,32,0.65625
Pressure,16,5,11,32,0.65625
The Suicide of Rachel Foster,61,23,44,128,0.65625
Dave Mirra Freestyle BMX 2,61,19,42,122,0.6557377049180327
Viking: Battle for Asgard,66,33,52,151,0.6556291390728477
X-Blades,30,29,31,90,0.6555555555555556
The Escapists 2,90,28,62,180,0.6555555555555556
Sniper Elite,93,25,62,180,0.6555555555555556
Disney Illusion Island,26,12,20,58,0.6551724137931034
Detective Pikachu Returns,12,26,20,58,0.6551724137931034
WWE All Stars,95,17,59,171,0.6549707602339181
Atom Zombie Smasher,62,12,39,113,0.6548672566371682
Hitman: Sniper Challenge,46,9,29,84,0.6547619047619048
Minecraft: Story Mode - Episode 7: Access Denied,31,5,19,55,0.6545454545454545
"Warhammer 40,000: Gladius - Relics of War",28,8,19,55,0.6545454545454545
Fractured Minds,19,17,19,55,0.6545454545454545
Rock of Ages,106,19,66,191,0.6544502617801047
Sniper Elite III,445,144,311,900,0.6544444444444445
Control: AWE,40,13,28,81,0.654320987654321
Beyond Eyes,27,26,28,81,0.654320987654321
Prison Break: The Conspiracy,23,26,26,75,0.6533333333333333
Assassin's Creed Chronicles: China,149,128,147,424,0.6533018867924528
Feudal Alloy,18,14,17,49,0.6530612244897959
Def Jam: Icon,4,28,17,49,0.6530612244897959
Mercenary Kings,110,82,102,294,0.6530612244897959
Medal of Honor Heroes 2,21,9,16,46,0.6521739130434783
Freedom Force vs The 3rd Reich,26,4,16,46,0.6521739130434783
Street Racing Syndicate,15,15,16,46,0.6521739130434783
Stikbold! A Dodgeball Adventure,25,5,16,46,0.6521739130434783
Prince of Persia,463,86,293,842,0.6520190023752969
Prototype (2009),574,89,354,1017,0.6519174041297935
Lifeless Planet,99,62,86,247,0.6518218623481782
Pokemon Quest,64,67,70,201,0.6517412935323383
Sid Meier's Civilization: Beyond Earth,345,368,381,1094,0.6517367458866545
Power Rangers: Battle for the Grid,26,17,23,66,0.6515151515151515
SpongeBob SquarePants: Creature from the Krusty Krab,32,11,23,66,0.6515151515151515
Aragami,89,25,61,175,0.6514285714285715
,188,88,148,424,0.6509433962264151
The Misadventures of P.B. Winterbottom,64,16,43,123,0.6504065040650406
Severed Steel,33,6,21,60,0.65
Dead Rising 2: Case West,19,7,14,40,0.65
Serious Sam: The Random Encounter,14,12,14,40,0.65
Adventure Time: Finn & Jake Investigations,27,12,21,60,0.65
Mutant Storm Empire,20,6,14,40,0.65
NightSky,53,10,34,97,0.6494845360824743
FIFA Street 2,47,3,27,77,0.6493506493506493
NBA Street,41,9,27,77,0.6493506493506493
Metal Gear Solid: Portable Ops,151,36,101,288,0.6493055555555556
Crash Bandicoot: The Wrath of Cortex,231,50,152,433,0.648960739030023
Hitman: Codename 47,187,20,112,319,0.6489028213166145
Kingdom Come: Deliverance - From The Ashes,14,10,13,37,0.6486486486486487
WWE SmackDown vs. Raw 2010,102,5,58,165,0.6484848484848484
Star Wars The Clone Wars: Republic Heroes,44,39,45,128,0.6484375
Transformers: The Game,47,47,51,145,0.6482758620689655
Enter the Matrix,115,14,70,199,0.6482412060301508
Digimon All-Star Rumble,17,18,19,54,0.6481481481481481
Color Guardians,31,15,25,71,0.647887323943662
Sonic and the Secret Rings,63,75,75,213,0.647887323943662
Harry Potter and the Prisoner of Azkaban,116,9,68,193,0.6476683937823834
Shatter (2009),57,11,37,105,0.6476190476190476
Assassin's Creed Syndicate: The Last Maharaja,20,13,18,51,0.6470588235294118
Redneck Rampage,17,5,12,34,0.6470588235294118
Samorost 1,21,1,12,34,0.6470588235294118
Face Noir,13,9,12,34,0.6470588235294118
Necromunda: Hired Gun,40,37,42,119,0.6470588235294118
Foreclosed,4,18,12,34,0.6470588235294118
Unrailed!,20,2,12,34,0.6470588235294118
Modern Combat: Domination,16,6,12,34,0.6470588235294118
Operation: Tango,26,7,18,51,0.6470588235294118
Among the Sleep,168,39,113,320,0.646875
Pokken Tournament,76,21,53,150,0.6466666666666666
The House of the Dead: Overkill,59,16,41,116,0.646551724137931
Deus Ex: Human Revolution - The Missing Link,168,24,105,297,0.6464646464646465
Truberbrook,20,22,23,65,0.6461538461538462
Tacoma,107,59,91,257,0.6459143968871596
Genesis Rising: The Universal Crusade,57,5,34,96,0.6458333333333334
Real Boxing,19,12,17,48,0.6458333333333334
Counter-Strike: Condition Zero,157,27,101,285,0.6456140350877193
Calling,49,2,28,79,0.6455696202531646
Car Mechanic Simulator 2018,27,13,22,62,0.6451612903225806
Adventures of Pip,16,4,11,31,0.6451612903225806
Football Manager Classic 2014,17,3,11,31,0.6451612903225806
Sideway: New York,12,8,11,31,0.6451612903225806
Duke Nukem: Land of the Babes,12,8,11,31,0.6451612903225806
Not a Hero,61,19,44,124,0.6451612903225806
The Mark of Kri,16,4,11,31,0.6451612903225806
Detective Gallo,14,6,11,31,0.6451612903225806
Drawn to Life: The Next Chapter,15,5,11,31,0.6451612903225806
Game & Wario,71,27,54,152,0.6447368421052632
Pilgrims,26,3,16,45,0.6444444444444445
Quake 4,230,27,142,399,0.6441102756892231
Brave Story: New Traveler,30,8,21,59,0.6440677966101694
Pro Evolution Soccer 2011,102,30,73,205,0.6439024390243903
How to Survive 2,30,17,26,73,0.6438356164383562
Disney*Pixar WALL-E,49,16,36,101,0.6435643564356436
Hard Reset Redux,54,20,41,115,0.6434782608695652
Capsized,63,20,46,129,0.6434108527131783
Crazy Taxi (1999),129,26,86,241,0.6431535269709544
Back to the Future: The Game,104,31,75,210,0.6428571428571429
Tourist Trophy,32,4,20,56,0.6428571428571429
Tenchu Z,45,9,30,84,0.6428571428571429
Spartacus Legends,40,50,50,140,0.6428571428571429
Oil Rush,22,14,20,56,0.6428571428571429
Cogs,29,7,20,56,0.6428571428571429
Trine 2: Director's Cut,109,26,75,210,0.6428571428571429
The Novelist,17,10,15,42,0.6428571428571429
F.E.A.R. 2: Project Origin,381,33,230,644,0.6428571428571429
Call of Duty: World at War - Final Fronts,18,9,15,42,0.6428571428571429
F1 2014,32,58,50,140,0.6428571428571429
Mass Effect 2: Overlord,144,23,93,260,0.6423076923076924
Tom Clancy's HAWX,63,16,44,123,0.6422764227642277
Stranded Deep,32,63,53,148,0.6418918918918919
Final Fantasy Origins,41,2,24,67,0.6417910447761194
Afterfall: InSanity - Extended Edition,22,12,19,53,0.6415094339622641
Felix the Reaper,26,8,19,53,0.6415094339622641
Star Wars: Starfighter,29,5,19,53,0.6415094339622641
Bad North,71,22,52,145,0.6413793103448275
Urban Empire,12,13,14,39,0.6410256410256411
Skyshine's Bedlam,9,16,14,39,0.6410256410256411
Blood Bowl: Legendary Edition,34,16,28,78,0.6410256410256411
The Ball,25,16,23,64,0.640625
Assassin's Creed Unity: Dead Kings,104,60,92,256,0.640625
LEGO Batman 3: Beyond Gotham,181,63,137,381,0.6404199475065617
Sniper Elite: Nazi Zombie Army 2,54,19,41,114,0.6403508771929824
Hunted: The Demon's Forge,142,75,122,339,0.640117994100295
Assassin's Creed: Altair's Chronicles,15,17,18,50,0.64
Rome: Total War Alexander,41,7,27,75,0.64
"Sir, You Are Being Hunted",31,17,27,75,0.64
Batman: Arkham Knight - A Matter of Family,64,23,49,136,0.6397058823529411
Guitar Hero 5,54,33,49,136,0.6397058823529411
Velvet Assassin,43,28,40,111,0.6396396396396397
F.E.A.R. Combat,32,7,22,61,0.639344262295082
ADR1FT,26,36,35,97,0.6391752577319587
RISK: Factions,15,8,13,36,0.6388888888888888
The Incredible Adventures of Van Helsing: Final Cut,37,9,26,72,0.6388888888888888
Secret Files 2: Puritas Cordis,16,7,13,36,0.6388888888888888
Need for Speed II,61,8,39,108,0.6388888888888888
Olija,19,4,13,36,0.6388888888888888
Gang Beasts,87,35,69,191,0.6387434554973822
Realm Royale,18,12,17,47,0.6382978723404256
Marvel's Guardians of the Galaxy: The Telltale Series,84,20,59,163,0.6380368098159509
King's Bounty: Warriors of the North,57,17,42,116,0.6379310344827587
Secret Ponchos,50,24,42,116,0.6379310344827587
Chronos: Before the Ashes,18,19,21,58,0.6379310344827587
The Legend of Heroes: Trails into Reverie,40,11,29,80,0.6375
Postal,77,32,62,171,0.6374269005847953
Madden NFL 12,69,54,70,193,0.6373056994818653
Batman Begins,69,3,41,113,0.6371681415929203
FIFA 08 Soccer,80,27,61,168,0.6369047619047619
Naruto: Ultimate Ninja Storm,94,27,69,190,0.6368421052631579
The Bureau: XCOM Declassified,392,184,329,905,0.63646408839779
Redeemer,23,5,16,44,0.6363636363636364
"Warhammer 40,000: Fire Warrior",16,5,12,33,0.6363636363636364
Tiny Troopers: Joint Ops,13,15,16,44,0.6363636363636364
The Fall of the Dungeon Guardians,14,7,12,33,0.6363636363636364
America's Army 3,19,9,16,44,0.6363636363636364
The Lamplighters League,14,14,16,44,0.6363636363636364
The Maw,17,4,12,33,0.6363636363636364
Gish,16,12,16,44,0.6363636363636364
Cargo! The Quest for Gravity,15,6,12,33,0.6363636363636364
Switch Galaxy Ultra,10,11,12,33,0.6363636363636364
Star Wars: The Clone Wars,33,2,20,55,0.6363636363636364
Stuntman,10,11,12,33,0.6363636363636364
Borderlands: Claptrap's New Robot Revolution,54,23,44,121,0.6363636363636364
Bionicle,16,19,20,55,0.6363636363636364
Blade Strangers,24,4,16,44,0.6363636363636364
Minit,82,30,64,176,0.6363636363636364
SD Gundam Battle Alliance,15,6,12,33,0.6363636363636364
Orcs Must Die! 3,17,4,12,33,0.6363636363636364
Animal Crossing: Happy Home Designer,66,23,51,140,0.6357142857142857
Call of Cthulhu: The Official Video Game,253,87,195,535,0.6355140186915887
Captain America: Super Soldier,66,14,46,126,0.6349206349206349
Age of Empires III: The WarChiefs,26,7,19,52,0.6346153846153846
Karaoke Revolution Volume 2,26,7,19,52,0.6346153846153846
RISK (2014),16,17,19,52,0.6346153846153846
LEGO The Hobbit,126,56,105,287,0.6341463414634146
Mosaic,14,12,15,41,0.6341463414634146
FIFA 2001 Major League Soccer,22,4,15,41,0.6341463414634146
Sniper Elite III: Ultimate Edition,36,9,26,71,0.6338028169014085
Demigod,37,8,26,71,0.6338028169014085
Monday Night Combat,140,26,96,262,0.6335877862595419
Metroid Prime Pinball,16,3,11,30,0.6333333333333333
Deadliest Warrior: The Game,8,11,11,30,0.6333333333333333
The Shapeshifting Detective,12,7,11,30,0.6333333333333333
The Council - Episode 4: Burning Bridges,15,4,11,30,0.6333333333333333
Comic Jumper: The Adventures of Captain Smiley,14,5,11,30,0.6333333333333333
Blocks That Matter,31,7,22,60,0.6333333333333333
The Political Machine 2012,12,7,11,30,0.6333333333333333
Anarchy Online,34,4,22,60,0.6333333333333333
Eschalon: Book III,12,7,11,30,0.6333333333333333
Bus Simulator 21,9,10,11,30,0.6333333333333333
Mario vs. Donkey Kong: Mini-Land Mayhem,18,1,11,30,0.6333333333333333
Letter Quest: Grimm's Journey,34,16,29,79,0.6329113924050633
Dead Island: Riptide,343,224,329,896,0.6328125
Stela,20,11,18,49,0.6326530612244898
Trivial Pursuit Live!,16,15,18,49,0.6326530612244898
Flashback: 25th Anniversary,53,9,36,98,0.6326530612244898
Runner3,22,9,18,49,0.6326530612244898
"Guns, Gore & Cannoli",64,10,43,117,0.6324786324786325
Game of Thrones: A Telltale Games Series,376,159,311,846,0.6323877068557919
Geometry Wars: Retro Evolved,70,16,50,136,0.6323529411764706
Genesis Noir,29,14,25,68,0.6323529411764706
Paradise Killer,84,14,57,155,0.632258064516129
Erica,179,68,144,391,0.6317135549872123
Black Mirror,18,42,35,95,0.631578947368421
Beyond Divinity,38,10,28,76,0.631578947368421
MySims,19,5,14,38,0.631578947368421
AaaaaAAaaaAAAaaAAAAaAAAAA!!!: A Reckless Disregard for Gravity,19,17,21,57,0.631578947368421
Sakura Spirit,9,15,14,38,0.631578947368421
Baja: Edge of Control,15,9,14,38,0.631578947368421
Stronghold: Crusader Extreme,20,16,21,57,0.631578947368421
Inversion,108,56,96,260,0.6307692307692307
Monster Energy Supercross - The Official Videogame 3,26,15,24,65,0.6307692307692307
Black Mirror III: Final Fear,26,3,17,46,0.6304347826086957
Audiosurf 2,24,5,17,46,0.6304347826086957
Storyteller,20,9,17,46,0.6304347826086957
Dordogne,21,8,17,46,0.6304347826086957
SOCOM: U.S. Navy SEALs Fireteam Bravo 2,27,2,17,46,0.6304347826086957
Champions Online,22,24,27,73,0.6301369863013698
Sacred Citadel,38,30,40,108,0.6296296296296297
LA Cops,20,14,20,54,0.6296296296296297
Half-Life 2: Lost Coast,81,4,50,135,0.6296296296296297
Lionheart: Legacy of the Crusader,29,5,20,54,0.6296296296296297
Kitten Squad,13,21,20,54,0.6296296296296297
Kamiko,64,9,43,116,0.6293103448275862
Fable III,532,354,522,1408,0.6292613636363636
Kane & Lynch 2: Dog Days,192,200,231,623,0.6292134831460674
Ridge Racer 3D,33,6,23,62,0.6290322580645161
Will Rock,32,7,23,62,0.6290322580645161
Fuel (2009),59,19,46,124,0.6290322580645161
OMSI 2,15,7,13,35,0.6285714285714286
Vambrace: Cold Soul,11,11,13,35,0.6285714285714286
Elven Legacy,16,6,13,35,0.6285714285714286
Tekken Revolution,44,22,39,105,0.6285714285714286
Blood Bowl,7,15,13,35,0.6285714285714286
Resident Evil: The Umbrella Chronicles,74,19,55,148,0.6283783783783784
Spy Chameleon,31,18,29,78,0.6282051282051282
Bang Bang Racing,18,9,16,43,0.627906976744186
The Settlers: Rise of an Empire,24,3,16,43,0.627906976744186
The Grim Adventures of Billy & Mandy,23,4,16,43,0.627906976744186
MonsterBag,22,5,16,43,0.627906976744186
FIFA Soccer 09,99,24,73,196,0.6275510204081632
Disciples III: Resurrection,10,22,19,51,0.6274509803921569
Bit.Trip Beat,16,16,19,51,0.6274509803921569
Bully: Scholarship Edition,726,155,524,1405,0.6270462633451958
The Simpsons Game,142,21,97,260,0.6269230769230769
Middle-earth: Shadow of Mordor - The Bright Lord,33,14,28,75,0.6266666666666667
Spider-Man: Edge of Time,75,19,56,150,0.6266666666666667
Resistance: Burning Skies,131,45,105,281,0.6263345195729537
Majesty 2: The Fantasy Kingdom Sim,53,9,37,99,0.6262626262626263
Call of Juarez,162,27,113,302,0.6258278145695364
Mars: War Logs,174,40,128,342,0.6257309941520468
Zeno Clash,92,25,70,187,0.6256684491978609
Two Worlds II: Pirates of the Flying Fortress,21,4,15,40,0.625
Legend of Dungeon,30,5,21,56,0.625
Disney/Pixar Cars Mater-National Championship,23,2,15,40,0.625
Batman: Arkham Knight - Red Hood Story Pack,22,8,18,48,0.625
Kao the Kangaroo,38,12,30,80,0.625
Assassin's Creed II: Bonfire of the Vanities,18,12,18,48,0.625
Excite Truck,19,1,12,32,0.625
Q.U.B.E.,75,10,51,136,0.625
Just Dance 2,16,4,12,32,0.625
Overland,17,8,15,40,0.625
SpellForce 2: Shadow Wars,85,16,61,162,0.6234567901234568
Sniper: Ghost Warrior,98,140,144,382,0.6230366492146597
Burnout (2001),32,6,23,61,0.6229508196721312
Assassin's Creed Odyssey - The Fate of Atlantis - Episode 3: Judgment of Atlantis,23,15,23,61,0.6229508196721312
Nintendogs + Cats: Golden Retriever & New Friends,27,6,20,53,0.6226415094339622
UFC Undisputed 2009,31,2,20,53,0.6226415094339622
NOVA-111,20,13,20,53,0.6226415094339622
Two Worlds II,249,122,225,596,0.62248322147651
Police Stories,15,8,14,37,0.6216216216216216
Tainted Grail: Conquest,20,3,14,37,0.6216216216216216
CSI: Crime Scene Investigation: Fatal Conspiracy,9,14,14,37,0.6216216216216216
Lovely Planet,18,5,14,37,0.6216216216216216
Mario Tennis Open,68,19,53,140,0.6214285714285714
Worms Revolution,72,33,64,169,0.621301775147929
Mass Effect: Pinnacle Station,19,40,36,95,0.6210526315789474
Moons of Madness,28,26,33,87,0.6206896551724138
Rogue Trooper Redux,25,11,22,58,0.6206896551724138
Assassin's Creed Odyssey - The Fate of Atlantis - Episode 2: Torment of Hades,23,13,22,58,0.6206896551724138
Assassin's Creed Origins: The Hidden Ones,107,32,85,224,0.6205357142857143
Medal of Honor: Pacific Assault,108,26,82,216,0.6203703703703703
Dragon Ball Z: Sagas,26,23,30,79,0.620253164556962
West of Dead,30,19,30,79,0.620253164556962
TimeShift (2007),122,20,87,229,0.6200873362445415
Assassin's Creed Rogue Remastered,136,50,114,300,0.62
Turmoil,29,2,19,50,0.62
Agatha Christie: The ABC Murders,22,9,19,50,0.62
Siren,64,11,46,121,0.6198347107438017
Worms Ultimate Mayhem,48,9,35,92,0.6195652173913043
Draugen,50,20,43,113,0.6194690265486725
DreamWorks Shrek Forever After,12,27,24,63,0.6190476190476191
Mortal Kombat 4,46,6,32,84,0.6190476190476191
Sonic Rivals,34,5,24,63,0.6190476190476191
American Conquest: Fight Back,32,7,24,63,0.6190476190476191
Serious Sam Double D,29,10,24,63,0.6190476190476191
Thunder Wolves,27,12,24,63,0.6190476190476191
Broken Sword: The Smoking Mirror,116,22,85,223,0.6188340807174888
Human: Fall Flat,153,30,113,296,0.6182432432432432
Batman: The Telltale Series,468,84,341,893,0.6181410974244121
Rocketbirds: Hardboiled Chicken,51,12,39,102,0.6176470588235294
Little Nightmares: The Hideaway,10,11,13,34,0.6176470588235294
Monopoly Streets,11,10,13,34,0.6176470588235294
AER: Memories of Old,65,27,57,149,0.6174496644295302
Refunct,24,5,18,47,0.6170212765957447
Uno (2016),42,24,41,107,0.616822429906542
Transformers: Revenge of the Fallen The Mobile Game,40,34,46,120,0.6166666666666667
Edge (2011),62,12,46,120,0.6166666666666667
Blackwood Crossing,27,10,23,60,0.6166666666666667
Sonic Unleashed,1524,275,1121,2920,0.6160958904109589
The Sims Medieval,73,52,78,203,0.6157635467980296
The Elder Scrolls V: Skyrim - Hearthfire,79,54,83,216,0.6157407407407407
Fallout: New Vegas - Lonesome Road,151,30,113,294,0.6156462585034014
Supraland: Six Inches Under,20,4,15,39,0.6153846153846154
Front Mission 4,23,1,15,39,0.6153846153846154
"The Chronicles of Narnia: The Lion, The Witch and The Wardrobe",18,6,15,39,0.6153846153846154
WinBack 2: Project Poseidon,3,21,15,39,0.6153846153846154
Pro Evolution Soccer 2009,61,11,45,117,0.6153846153846154
Crimson Alliance,18,6,15,39,0.6153846153846154
Etrian Odyssey Nexus,38,2,25,65,0.6153846153846154
Mortal Kombat Arcade Kollection,37,22,37,96,0.6145833333333334
Suikoden IV,36,7,27,70,0.6142857142857143
Dragon Ball Z: Budokai Tenkaichi,34,1,22,57,0.6140350877192983
Crackdown 2,55,42,61,158,0.6139240506329114
Table Top Racing: World Tour,55,37,58,150,0.6133333333333333
Naughty Bear,20,26,29,75,0.6133333333333333
The Tiny Bang Story,38,8,29,75,0.6133333333333333
Batman: The Telltale Series - Episode 5: City of Light,47,18,41,106,0.6132075471698113
Mario Party Advance,10,28,24,62,0.6129032258064516
Battlestar Galactica Deadlock,18,1,12,31,0.6129032258064516
True Crime: New York City,60,16,48,124,0.6129032258064516
Victor Vran: Overkill Edition,33,5,24,62,0.6129032258064516
Greed Corp,30,8,24,62,0.6129032258064516
Nidhogg 2,24,14,24,62,0.6129032258064516
Flockers,7,12,12,31,0.6129032258064516
Assassin's Creed II: Battle of Forli,17,13,19,49,0.6122448979591837
Anna: Extended Edition,28,32,38,98,0.6122448979591837
Silent Hill: Homecoming,209,132,216,557,0.6122082585278277
Manual Samuel,26,15,26,67,0.6119402985074627
Clustertruck,63,33,61,157,0.6114649681528662
New Super Mario Bros. 2,365,85,286,736,0.6114130434782609
Maize,19,3,14,36,0.6111111111111112
Party Hard,74,14,56,144,0.6111111111111112
Event[0],27,6,21,54,0.6111111111111112
Bridge Constructor,14,8,14,36,0.6111111111111112
Emily is Away,38,9,30,77,0.6103896103896104
Broken Sword: The Shadow of the Templars,40,7,30,77,0.6103896103896104
X-Men: The Official Game,28,8,23,59,0.6101694915254238
WWE '12,96,37,85,218,0.6100917431192661
Violett,15,10,16,41,0.6097560975609756
James Bond 007: Agent Under Fire,39,11,32,82,0.6097560975609756
Lust from Beyond,18,7,16,41,0.6097560975609756
Half-Life 2: Deathmatch,43,7,32,82,0.6097560975609756
NASCAR Heat 5,14,11,16,41,0.6097560975609756
Naruto Shippuden: Ultimate Ninja Storm 4 - Road to Boruto Expansion,30,9,25,64,0.609375
Spec Ops: The Line,2704,505,2061,5270,0.6089184060721062
March of the Eagles,21,7,18,46,0.6086956521739131
Helldivers,672,99,497,1268,0.6080441640378549
Need for Speed: Shift,238,109,224,571,0.6077057793345009
Layton's Mystery Journey: Katrielle and The Millionaires' Conspiracy - Deluxe Edition,25,9,22,56,0.6071428571428571
The LEGO NINJAGO Movie Video Game,54,31,55,140,0.6071428571428571
Rayman Raving Rabbids 2,21,13,22,56,0.6071428571428571
A New Beginning,42,15,37,94,0.6063829787234043
And Yet It Moves,48,29,50,127,0.6062992125984252
Back to the Future: The Game - Episode I: It's About Time,75,25,65,165,0.6060606060606061
Street Fighter II' Hyper Fighting,19,1,13,33,0.6060606060606061
Virtua Tennis 2009,16,4,13,33,0.6060606060606061
InnerSpace,9,11,13,33,0.6060606060606061
The Sims 2: Pets,26,14,26,66,0.6060606060606061
Buffy the Vampire Slayer: Chaos Bleeds,16,4,13,33,0.6060606060606061
Leviathan: Warships,12,8,13,33,0.6060606060606061
Spider-Man 2,151,32,119,302,0.6059602649006622
Tank! Tank! Tank!,23,20,28,71,0.6056338028169014
Pokemon Dash,7,16,15,38,0.6052631578947368
Patrician IV: Conquest by Trade,14,9,15,38,0.6052631578947368
Golden Axe: Beast Rider,10,13,15,38,0.6052631578947368
Penny Arcade Adventures: Episode One,23,3,17,43,0.6046511627906976
Lilly Looking Through,17,9,17,43,0.6046511627906976
Maquette,50,34,55,139,0.60431654676259
Assassin's Creed IV: Black Flag - Freedom Cry,264,101,239,604,0.6043046357615894
Deadlight: Director's Cut,40,18,38,96,0.6041666666666666
Metrico,14,15,19,48,0.6041666666666666
Jotun,85,34,78,197,0.6040609137055838
Harry Potter and the Goblet of Fire,29,76,69,174,0.603448275862069
Drakengard 2,24,11,23,58,0.603448275862069
Zuma Deluxe,29,6,23,58,0.603448275862069
Layers of Fear: Inheritance,35,12,31,78,0.6025641025641025
NecroVisioN,31,19,33,83,0.6024096385542169
Lara Croft Tomb Raider: The Angel of Darkness,69,40,72,181,0.6022099447513812
Trine 3: The Artifacts of Power,94,37,87,218,0.6009174311926605
Bus Driver,17,4,14,35,0.6
Plague Road,6,15,14,35,0.6
Feist,14,7,14,35,0.6
Armikrog,34,44,52,130,0.6
Skyhill,16,14,20,50,0.6
Disc Room,14,4,12,30,0.6
One Piece: Grand Battle,13,5,12,30,0.6
Uno,20,1,14,35,0.6
Power Rangers: Super Legends - 15th Anniversary,9,9,12,30,0.6
The Expendabros - Broforce: The Expendables Missions,26,4,20,50,0.6
Age of Booty,9,12,14,35,0.6
Evan's Remains,14,4,12,30,0.6
Star Wars The Clone Wars: Lightsaber Duels,15,6,14,35,0.6
Sega Superstars Tennis,32,4,24,60,0.6
Disney Epic Mickey: The Power of Illusion,13,11,16,40,0.6
Heroes of Might and Magic IV: The Gathering Storm,23,1,16,40,0.6
FIFA Soccer 2003,32,13,30,75,0.6
Collection of Mana,51,6,38,95,0.6
Super Robot Wars 30,15,3,12,30,0.6
Runes of Magic,11,16,18,45,0.6
Dead to Rights: Retribution,24,12,24,60,0.6
Beautiful Katamari,15,3,12,30,0.6
Homefront,394,377,515,1286,0.5995334370139969
Clive Barker's Jericho,148,15,109,272,0.5992647058823529
Red Faction: Armageddon,209,78,192,479,0.5991649269311065
Hydrophobia: Prophecy,56,62,79,197,0.5989847715736041
Scribblenauts Unmasked: A DC Comics Adventure,50,26,51,127,0.5984251968503937
AdVenture Capitalist,30,34,43,107,0.5981308411214953
Area 51 (2005),50,11,41,102,0.5980392156862745
12 is Better Than 6,30,16,31,77,0.5974025974025974
SiN Episodes: Emergence,37,6,29,72,0.5972222222222222
Pikuniku,72,11,56,139,0.5971223021582733
Conan (2007),25,12,25,62,0.5967741935483871
Medal of Honor: Allied Assault - Breakthrough,30,7,25,62,0.5967741935483871
PAM: Post Apocalyptic Mayhem,27,10,25,62,0.5967741935483871
Pilotwings Resort,57,8,44,109,0.5963302752293578
Myst IV: Revelation,53,9,42,104,0.5961538461538461
Frontlines: Fuel of War,40,19,40,99,0.5959595959595959
Assassin's Creed III - The Redemption,33,26,40,99,0.5959595959595959
Naruto: Rise of a Ninja,26,2,19,47,0.5957446808510638
Nintendogs: Lab & Friends,25,3,19,47,0.5957446808510638
The Playroom,21,7,19,47,0.5957446808510638
Sonic the Hedgehog 2,45,8,36,89,0.5955056179775281
Serious Sam II,148,30,121,299,0.5953177257525084
Pure,67,8,51,126,0.5952380952380952
Super Monkey Ball: Banana Blitz,12,13,17,42,0.5952380952380952
A Memoir Blue,33,17,34,84,0.5952380952380952
Nickelodeon Kart Racers 2: Grand Prix,21,4,17,42,0.5952380952380952
Secret Agent Clank,37,10,32,79,0.5949367088607594
Crash Bandicoot Purple: Ripto's Rampage,11,11,15,37,0.5945945945945946
3 on 3 NHL Arcade,15,7,15,37,0.5945945945945946
Tiny & Big: Grandpa's Leftovers,53,10,43,106,0.5943396226415094
Sacred 2: Fallen Angel,91,35,86,212,0.5943396226415094
Breath of Death VII: The Beginning,25,16,28,69,0.5942028985507246
Gunvolt Chronicles: Luminous Avenger iX,39,2,28,69,0.5942028985507246
Resident Evil: Survivor,33,24,39,96,0.59375
Tokyo 42,11,8,13,32,0.59375
Back to the Future: The Game - Episode II: Get Tannen!,32,6,26,64,0.59375
Don't Knock Twice,4,15,13,32,0.59375
Stronghold: Warlords,12,7,13,32,0.59375
Mass Effect 2: Kasumi - Stolen Memory,102,9,76,187,0.5935828877005348
Dear Esther: Landmark Edition,41,32,50,123,0.5934959349593496
Tails Noir,39,15,37,91,0.5934065934065934
Late Shift,85,30,79,194,0.5927835051546392
The Lord of the Rings: Conquest,81,25,73,179,0.5921787709497207
Alien Shooter 2: Reloaded,26,3,20,49,0.5918367346938775
Star Fox Command,18,11,20,49,0.5918367346938775
Puzzle Quest 2,31,11,29,71,0.5915492957746479
Mercenaries 2: World in Flames,64,33,67,164,0.5914634146341463
Hard Truck: Apocalypse,71,10,56,137,0.5912408759124088
A Game of Dwarves,27,12,27,66,0.5909090909090909
Receiver,12,14,18,44,0.5909090909090909
Nicktoons Unite!,15,11,18,44,0.5909090909090909
Before We Leave,23,3,18,44,0.5909090909090909
Wizorb,13,13,18,44,0.5909090909090909
Spider-Man: The Movie,80,11,63,154,0.5909090909090909
Kona,77,18,66,161,0.5900621118012422
Teen Titans,19,4,16,39,0.5897435897435898
Post Mortem,18,5,16,39,0.5897435897435898
Northland,21,2,16,39,0.5897435897435898
F.E.A.R. Extraction Point,99,10,76,185,0.5891891891891892
Assassin's Creed Odyssey: Story Arc 1 - Legacy of the First Blade,26,17,30,73,0.589041095890411
Contrast (2013),291,96,270,657,0.589041095890411
Age of Conan: Unchained,45,8,37,90,0.5888888888888889
That's You!,25,5,21,51,0.5882352941176471
Monopoly: Family Fun Pack,8,12,14,34,0.5882352941176471
SANABI,44,6,35,85,0.5882352941176471
Jaws Unleashed,18,2,14,34,0.5882352941176471
Aerena: Clash of Champions,48,2,35,85,0.5882352941176471
Sleeping Dogs: Year of the Snake,13,7,14,34,0.5882352941176471
Pneuma: Breath of Life,36,14,35,85,0.5882352941176471
The Coma: Recut,14,6,14,34,0.5882352941176471
Superfrog HD,17,23,28,68,0.5882352941176471
Steel Soldiers,18,2,14,34,0.5882352941176471
Osmos,55,12,47,114,0.5877192982456141
ARMS,77,71,104,252,0.5873015873015873
Infernal,17,10,19,46,0.5869565217391305
Fallout: New Vegas - Courier's Stash,16,11,19,46,0.5869565217391305
The Dark Eye: Demonicon,29,15,31,75,0.5866666666666667
The Dark Pictures Anthology: Man of Medan,388,251,451,1090,0.5862385321100917
The Journey Down: Chapter One,30,4,24,58,0.5862068965517241
Blacklight: Tango Down,14,20,24,58,0.5862068965517241
Bit.Trip Runner,45,23,48,116,0.5862068965517241
Assassin's Creed,1769,279,1447,3495,0.5859799713876968
Disciples III: Renaissance,20,38,41,99,0.5858585858585859
Wii Fit Plus,38,3,29,70,0.5857142857142857
WWE SmackDown vs. Raw 2008,69,13,58,140,0.5857142857142857
NyxQuest: Kindred Spirits,35,6,29,70,0.5857142857142857
Phantasy Star Universe,17,7,17,41,0.5853658536585366
Harry Potter and the Sorcerer's Stone,165,27,136,328,0.5853658536585366
Narco Terror,9,15,17,41,0.5853658536585366
CounterSpy,106,32,98,236,0.5847457627118644
Evil Islands: Curse of the Lost Soul,75,8,59,142,0.5845070422535211
Pokemon Rumble Blast,33,12,32,77,0.5844155844155844
Revenge of the Titans,46,6,37,89,0.5842696629213483
Naruto: Ultimate Ninja 2,20,1,15,36,0.5833333333333334
Ironclad Tactics,22,6,20,48,0.5833333333333334
Tales of Monkey Island Chapter 2: The Siege of Spinner Cay,19,2,15,36,0.5833333333333334
SoulCalibur: Broken Destiny,24,4,20,48,0.5833333333333334
Defy Gravity Extended,13,8,15,36,0.5833333333333334
Mortal Kombat: Deadly Alliance,90,15,75,180,0.5833333333333334
Gratuitous Space Battles,27,8,25,60,0.5833333333333334
Mario Party: Island Tour,55,50,75,180,0.5833333333333334
Madden NFL 10,31,11,30,72,0.5833333333333334
Black & White 2,50,10,43,103,0.5825242718446602
True Crime: Streets of LA,64,14,56,134,0.582089552238806
Yoshi's Story,60,11,51,122,0.5819672131147541
Sleeping Dogs: Nightmare in North Point,18,14,23,55,0.5818181818181818
Faery: Legends of Avalon,23,9,23,55,0.5818181818181818
The Silver Case,85,4,64,153,0.5816993464052288
Tekken Tag Tournament,137,20,113,270,0.5814814814814815
Rabbids Land,12,13,18,43,0.5813953488372093
Ben 10: Power Trip,8,17,18,43,0.5813953488372093
"Dr. Langeskov, The Tiger, and The Terribly Cursed Emerald: A Whirlwind Heist",23,2,18,43,0.5813953488372093
Lego Indiana Jones 2: The Adventure Continues,80,24,75,179,0.5810055865921788
Rocket Knight,16,2,13,31,0.5806451612903226
Defunct,13,5,13,31,0.5806451612903226
Crashday,16,2,13,31,0.5806451612903226
Sea Dogs,49,5,39,93,0.5806451612903226
Bomberman Ultra,17,1,13,31,0.5806451612903226
Disney's Donald Duck: Goin' Quackers,30,6,26,62,0.5806451612903226
Sinking Island,14,4,13,31,0.5806451612903226
Donut County,144,26,123,293,0.5802047781569966
Luigi's Mansion: Dark Moon,682,89,558,1329,0.5801354401805869
Ratchet & Clank: All 4 One,106,39,105,250,0.58
Trauma,12,17,21,50,0.58
Back to the Future: The Game - Episode IV: Double Visions,18,11,21,50,0.58
Arx Fatalis,165,20,134,319,0.5799373040752351
Harry Potter and the Half-Blood Prince,46,60,77,183,0.5792349726775956
SimCity Societies,7,26,24,57,0.5789473684210527
Punch-Out!!,120,16,99,235,0.5787234042553191
Virtua Tennis 4,42,17,43,102,0.5784313725490197
SimCity 4: Rush Hour,43,5,35,83,0.5783132530120482
A Bird Story,76,20,70,166,0.5783132530120482
Pro Evolution Soccer 2008,40,12,38,90,0.5777777777777777
Marvel's Spider-Man: Turf Wars,59,27,63,149,0.5771812080536913
The Station,22,8,22,52,0.5769230769230769
Blood Stone: 007,129,18,108,255,0.5764705882352941
Borderlands 2: Sir Hammerlock's Big Game Hunt,57,41,72,170,0.5764705882352941
Commandos 3: Destination Berlin,49,4,39,92,0.5760869565217391
Submerged,30,46,56,132,0.5757575757575758
Command & Conquer: Red Alert 3 - Uprising,41,16,42,99,0.5757575757575758
Youtubers Life,24,14,28,66,0.5757575757575758
Rabbids Travel in Time 3D,16,7,17,40,0.575
Professor Layton and the Diabolical Box,122,16,102,240,0.575
Wizardry 8,20,3,17,40,0.575
Sonic 3D Blast,26,20,34,80,0.575
Operation Flashpoint: Dragon Rising,58,61,88,207,0.5748792270531401
Valkyria Chronicles,803,84,656,1543,0.5748541801685029
Star Wars: The Force Unleashed - Ultimate Sith Edition,115,51,123,289,0.5743944636678201
Call of Duty 4: Modern Warfare,5760,668,4764,11192,0.5743388134381702
Burly Men at Sea,18,29,35,82,0.573170731707317
Dragon Age: Origins - Witch Hunt,48,54,76,178,0.5730337078651685
Call of Duty 3,253,94,259,606,0.5726072607260726
Need for Speed World,45,46,68,159,0.5723270440251572
Pokemon Shuffle,56,43,74,173,0.5722543352601156
Ad Infinitum,12,8,15,35,0.5714285714285714
Tom Clancy's Rainbow Six: Lockdown,7,17,18,42,0.5714285714285714
Steel Diver,11,9,15,35,0.5714285714285714
Dead Space 2: Severed,27,9,27,63,0.5714285714285714
Back to the Future: The Game - Episode III: Citizen Brown,21,11,24,56,0.5714285714285714
Band Hero,15,9,18,42,0.5714285714285714
Race the Sun,92,33,94,219,0.5707762557077626
Neon Abyss,47,22,52,121,0.5702479338842975
FIFA Soccer 2004,44,13,43,100,0.57
LEGO Pirates of the Caribbean: The Video Game,126,13,105,244,0.569672131147541
Medal of Honor: Airborne,185,28,161,374,0.56951871657754
Zombie Driver,26,15,31,72,0.5694444444444444
Sniper Elite V2,392,155,414,961,0.5691987513007284
Trek to Yomi,127,77,155,359,0.5682451253481894
nail'd,41,9,38,88,0.5681818181818182
DreamWorks Madagascar,61,2,48,111,0.5675675675675675
F1 Manager 2023,14,7,16,37,0.5675675675675675
Dungeon Siege: Legends of Aranna,20,1,16,37,0.5675675675675675
Little Nightmares: The Residence,7,14,16,37,0.5675675675675675
Shank,125,35,122,282,0.5673758865248227
Lara Croft and the Temple of Osiris,117,65,139,321,0.5669781931464174
CSI: Crime Scene Investigation: Hard Evidence,7,10,13,30,0.5666666666666667
Midnight Club: Street Racing,15,2,13,30,0.5666666666666667
112 Operator,15,2,13,30,0.5666666666666667
Naruto Shippuden: Ultimate Ninja Heroes 3,11,6,13,30,0.5666666666666667
Jackass the Game,11,6,13,30,0.5666666666666667
The Complex,32,15,36,83,0.5662650602409639
Zombie Driver HD,14,16,23,53,0.5660377358490566
Uncharted 3: Drake's Deception,5585,523,4683,10791,0.5660272449263275
Saints Row: Gat Out of Hell,134,121,196,451,0.565410199556541
Car Mechanic Simulator 2014,29,10,30,69,0.5652173913043478
Batman: Arkham Knight - Catwoman's Revenge,16,10,20,46,0.5652173913043478
Star Wars: Knights of the Old Republic II - The Sith Lords,1082,116,922,2120,0.5650943396226416
Evoland,91,33,96,220,0.5636363636363636
Halo 3,3479,318,2947,6744,0.5630189798339265
The Fidelio Incident,10,8,14,32,0.5625
Company of Heroes: Tales of Valor,54,9,49,112,0.5625
Starship Troopers - Terran Command,12,6,14,32,0.5625
Turning Point: Fall of Liberty,8,28,28,64,0.5625
Commandos Strike Force,33,8,32,73,0.5616438356164384
Medal of Honor: Rising Sun,46,9,43,98,0.5612244897959183
Wheels of Aurelia,2,21,18,41,0.5609756097560976
25 to Life,14,23,29,66,0.5606060606060606
The Incredible Hulk (2008),27,24,40,91,0.5604395604395604
Lake,46,24,55,125,0.56
Datura,14,14,22,50,0.56
Yakuza 3 Remastered,83,20,81,184,0.5597826086956522
The Great Ace Attorney Chronicles,521,18,424,963,0.5597092419522326
Brawlout,16,17,26,59,0.559322033898305
Soldier of Fortune II: Double Helix,90,14,82,186,0.5591397849462365
Prince of Persia: The Forgotten Sands,267,51,251,569,0.5588752196836555
Pokemon Channel,12,7,15,34,0.5588235294117647
Strange Horticulture,13,6,15,34,0.5588235294117647
Toby: The Secret Mine,10,9,15,34,0.5588235294117647
Create,9,10,15,34,0.5588235294117647
Metamorphosis,17,2,15,34,0.5588235294117647
Killzone HD,42,20,49,111,0.5585585585585585
Act of War: Direct Action,43,5,38,86,0.5581395348837209
Backgammon Blitz,12,12,19,43,0.5581395348837209
Pokemon Rumble World,36,22,46,104,0.5576923076923077
Pokemon Ultra Moon,58,5,50,113,0.5575221238938053
The Bridge (2013),86,16,81,183,0.5573770491803278
Dragon Age: Inquisition - Jaws Of Hakkon,60,33,74,167,0.5568862275449101
Beautiful Desolation,18,7,20,45,0.5555555555555556
Driftmoon,18,2,16,36,0.5555555555555556
The Bunker,25,35,48,108,0.5555555555555556
Dragon Ball Z: Budokai,42,3,36,81,0.5555555555555556
RUSH (2010),25,5,24,54,0.5555555555555556
Swords & Soldiers,33,12,36,81,0.5555555555555556
Aliens vs. Predator,311,65,301,677,0.5553914327917282
Valkyrie Profile 2: Silmeria,102,9,89,200,0.555
Stronghold,373,37,330,740,0.5540540540540541
Klonoa 2: Lunatea's Veil,127,7,108,242,0.5537190082644629
Yakuza 0,2329,137,1991,4457,0.5532869643257796
Lost Planet: Extreme Condition,95,30,101,226,0.5530973451327433
Mass Effect 2: Arrival,102,66,136,304,0.5526315789473685
Saints Row IV: Enter the Dominatrix,14,7,17,38,0.5526315789473685
Rune Factory 3 Special,20,1,17,38,0.5526315789473685
To the Moon,1599,122,1397,3118,0.5519563822963438
Project: Snowblind,20,12,26,58,0.5517241379310345
Worldwide Soccer Manager 2009,29,3,26,58,0.5517241379310345
Kung Fu Rabbit,18,14,26,58,0.5517241379310345
Star Wars: The Force Unleashed II,236,168,329,733,0.5511596180081856
Batman: Arkham City - Harley Quinn's Revenge,101,23,101,225,0.5511111111111111
Kane & Lynch: Dead Men,113,72,151,336,0.5505952380952381
Garou: Mark of the Wolves,20,2,18,40,0.55
Serious Sam 3: Jewel of the Nile,11,6,14,31,0.5483870967741935
The Settlers II Gold Edition,16,1,14,31,0.5483870967741935
Excitebike,12,5,14,31,0.5483870967741935
Worms Battlegrounds,40,28,56,124,0.5483870967741935
Haze,12,39,42,93,0.5483870967741935
36 Fragments of Midnight,2,21,19,42,0.5476190476190477
Hot Shots Golf: Open Tee 2,42,4,38,84,0.5476190476190477
A.R.E.S. Extinction Agenda,15,14,24,53,0.5471698113207547
Road Not Taken,32,26,48,106,0.5471698113207547
F.E.A.R. 3,279,174,375,828,0.5471014492753623
Middle-earth: Shadow of Mordor - Lord of the Hunt,23,12,29,64,0.546875
WWE SmackDown vs. Raw 2009,58,12,58,128,0.546875
Portal: Still Alive,265,22,238,525,0.5466666666666666
Bakugan: Defenders of the Core,16,2,15,33,0.5454545454545454
The Incredible Adventures of Van Helsing III,20,10,25,55,0.5454545454545454
The Lord of the Rings: Aragorn's Quest,16,8,20,44,0.5454545454545454
Reigns,51,9,50,110,0.5454545454545454
The Little Acre,24,12,30,66,0.5454545454545454
Unreal Tournament (1999),61,5,55,121,0.5454545454545454
The King of Fighters XII,10,8,15,33,0.5454545454545454
007: The World is not Enough,39,4,36,79,0.5443037974683544
Enclave,54,14,57,125,0.544
Pilotwings 64,29,2,26,57,0.543859649122807
A Story About My Uncle,81,19,84,184,0.5434782608695652
Men of War: Vietnam,11,14,21,46,0.5434782608695652
Baldur's Gate II: Throne of Bhaal,348,21,310,679,0.5434462444771723
Darkest of Days,21,17,32,70,0.5428571428571428
Broken Sword 5: The Serpents' Curse - Part II,30,2,27,59,0.5423728813559322
Neverwinter Nights 2: Storm of Zehir,25,7,27,59,0.5423728813559322
Resident Evil: Dead Aim,33,12,38,83,0.5421686746987951
Age of Empires II: The Age of Kings,1405,100,1274,2779,0.5415617128463476
Disgaea 7: Vows of the Virtueless,31,2,28,61,0.5409836065573771
Big Sky: Infinity,7,13,17,37,0.5405405405405406
Rise of the Argonauts,51,9,51,111,0.5405405405405406
SUPERHOT: MIND CONTROL DELETE,79,28,91,198,0.5404040404040404
Hardware: Rivals,16,31,40,87,0.5402298850574713
System Shock 2,654,40,591,1285,0.5400778210116731
LEGO Builder's Journey,22,5,23,50,0.54
Venba,23,11,29,63,0.5396825396825397
Shadowgrounds Survivor,18,3,18,39,0.5384615384615384
Night Call,11,10,18,39,0.5384615384615384
Harry Potter: Quidditch World Cup,30,12,36,78,0.5384615384615384
Mass Effect: Bring Down the Sky,51,5,48,104,0.5384615384615384
Poker Night at the Inventory,52,12,55,119,0.5378151260504201
Lucius,57,50,92,199,0.5376884422110553
Disney Universe,21,8,25,54,0.5370370370370371
Doritos Crash Course,31,13,38,82,0.5365853658536586
Red Faction II,47,20,58,125,0.536
Pinstripe,28,2,26,56,0.5357142857142857
Just Cause,93,52,126,271,0.5350553505535055
Boiling Point,17,6,20,43,0.5348837209302325
Pathway,16,7,20,43,0.5348837209302325
Lost: Via Domus,25,22,41,88,0.5340909090909091
Assassin's Creed Liberation HD,142,148,253,543,0.5340699815837937
7 Grand Steps,12,4,14,30,0.5333333333333333
Nikopol: Secrets of the Immortals,7,9,14,30,0.5333333333333333
We Were Here Together,15,1,14,30,0.5333333333333333
Fire Emblem: Shadow Dragon,68,13,71,152,0.5328947368421053
Golf With Your Friends,38,29,59,126,0.5317460317460317
Venetica,44,15,52,111,0.5315315315315315
Mass Effect 3: Firefight Pack,13,4,15,32,0.53125
The Simpsons Wrestling,7,10,15,32,0.53125
Cities XL 2012,23,29,46,98,0.5306122448979592
Battlestations: Midway,14,4,16,34,0.5294117647058824
Spider-Man: Friend or Foe,56,16,64,136,0.5294117647058824
Fallout 3: Mothership Zeta,50,50,89,189,0.5291005291005291
The Book of Unwritten Tales: Critter Chronicles,16,3,17,36,0.5277777777777778
Serena,21,8,26,55,0.5272727272727272
Little Nightmares: The Depths,15,14,26,55,0.5272727272727272
Pikmin 3 Deluxe,95,4,89,188,0.526595744680851
Shaun White Snowboarding,13,7,18,38,0.5263157894736842
God Hand,802,17,739,1558,0.5256739409499358
Wario World,29,2,28,59,0.5254237288135594
Gamedec,23,8,28,59,0.5254237288135594
Cities XL 2011,9,12,19,40,0.525
Fruit Ninja Kinect,14,7,19,40,0.525
Amnesia: Memories,16,5,19,40,0.525
Batman: Arkham Origins Blackgate - Deluxe Edition,56,29,77,162,0.5246913580246914
F.E.A.R. Perseus Mandate,64,11,68,143,0.5244755244755245
Family Guy,16,6,20,42,0.5238095238095238
Beatbuddy: Tale of the Guardians,20,2,20,42,0.5238095238095238
Batman: Arkham Knight - Harley Quinn Story Pack,14,8,20,42,0.5238095238095238
Need for Speed: Undercover,162,146,280,588,0.5238095238095238
Old Man's Journey,55,24,72,151,0.5231788079470199
1954: Alcatraz,15,8,21,44,0.5227272727272727
Potion Craft: Alchemist Simulator,18,5,21,44,0.5227272727272727
Shadowgrounds,25,10,32,67,0.5223880597014925
Fallout 3: The Pitt,95,11,97,203,0.5221674876847291
Dragon Age: Inquisition - The Descent,39,22,56,117,0.5213675213675214
Sheltered,17,21,35,73,0.5205479452054794
Wet,49,16,60,125,0.52
The Club,14,13,25,52,0.5192307692307693
Scribblenauts,28,2,28,58,0.5172413793103449
Army of Two: The 40th Day,85,21,99,205,0.5170731707317073
Mortal Kombat vs. DC Universe,89,27,109,225,0.5155555555555555
Castlevania Judgment,1,16,16,33,0.5151515151515151
Ninja Blade,31,20,48,99,0.5151515151515151
Pokemon Battle Revolution,47,23,66,136,0.5147058823529411
FIFA 06: Road to FIFA World Cup,47,7,51,105,0.5142857142857142
Mass Effect 2: The Price of Revenge,30,6,34,70,0.5142857142857142
Harms Way,9,9,17,35,0.5142857142857142
Stuntman: Ignition,15,3,17,35,0.5142857142857142
Ninja Gaiden (2004),178,4,172,354,0.5141242937853108
Solar 2,30,8,36,74,0.5135135135135135
Avencast: Rise of the Mage,13,6,18,37,0.5135135135135135
NCAA Football 2005,76,2,74,152,0.5131578947368421
Forgotten Realms: Demon Stone,12,8,19,39,0.5128205128205128
Warhammer: Mark of Chaos,17,4,20,41,0.5121951219512195
The Lord of the Rings: The Fellowship of the Ring,26,20,44,90,0.5111111111111111
Carmageddon 3: TDR 2000,18,8,25,51,0.5098039215686274
Chrome,19,8,26,53,0.5094339622641509
Dark Sector,74,25,96,195,0.5076923076923077
Mass Effect 2: Normandy Crash Site,23,11,33,67,0.5074626865671642
Hoard,24,10,33,67,0.5074626865671642
Assassin's Creed: Bloodlines,54,16,68,138,0.5072463768115942
Penumbra: Requiem,26,27,52,105,0.5047619047619047
flOw,81,39,118,238,0.5042016806722689
Arthur and the Invisibles,10,9,19,38,0.5
Gomo,5,11,16,32,0.5
Risen,33,7,40,80,0.5
Loki,5,11,16,32,0.5
Bullet Witch,13,11,24,48,0.5
Midtown Madness,13,3,16,32,0.5
Crayon Physics Deluxe,34,4,38,76,0.5
The Guild 2,20,4,24,48,0.5
Pokemon Dream Radar,8,7,15,30,0.5
Medal of Honor: Vanguard,19,10,29,58,0.5
The Long Reach,15,6,21,42,0.5
Hot Shots Tennis,21,1,22,44,0.5
Link's Crossbow Training,16,5,21,42,0.5
Art Academy: Sketchpad,11,4,15,30,0.5
50 Cent: Blood on the Sand,25,19,45,89,0.4943820224719101
Sonic the Fighters,25,8,34,67,0.4925373134328358
Bleach: Soul Resurreccion,28,4,33,65,0.49230769230769234
Fallout 3 - Operation: Anchorage,54,41,98,193,0.49222797927461137
Batman: Vengeance,24,5,30,59,0.4915254237288136
Estranged: Act I,18,5,24,47,0.48936170212765956
Naruto: Ultimate Ninja,16,4,21,41,0.4878048780487805
Robert Ludlum's The Bourne Conspiracy,32,5,39,76,0.4868421052631579
Earthlock,15,3,19,37,0.4864864864864865
Heroes of Might and Magic IV: Winds of War,16,1,18,35,0.4857142857142857
Pokedex 3D,12,5,18,35,0.4857142857142857
Alpha Prime,14,20,36,70,0.4857142857142857
I Am Fish,11,6,18,35,0.4857142857142857
Pirates of Black Cove,7,9,17,33,0.48484848484848486
Batman: Arkham Knight - A Flip of a Coin,11,5,17,33,0.48484848484848486
The House of the Dead 2 & 3 Return,14,1,16,31,0.4838709677419355
Nicktoons: Battle for Volcano Island,13,2,16,31,0.4838709677419355
Under The Waves,17,13,32,62,0.4838709677419355
Never Alone (2014),144,66,226,436,0.481651376146789
Afro Samurai,19,20,42,81,0.48148148148148145
Saw,32,19,55,106,0.4811320754716981
Ghost Rider,22,1,25,48,0.4791666666666667
Jalopy,16,5,23,44,0.4772727272727273
Eat Lead: The Return of Matt Hazard,11,9,22,42,0.47619047619047616
James Cameron's Avatar: The Game,48,42,99,189,0.47619047619047616
Fallout: New Vegas - Honest Hearts,119,28,162,309,0.47572815533980584
Heritage of Kings: The Settlers,15,4,21,40,0.475
Lost Planet: Extreme Condition Colonies Edition,21,5,29,55,0.4727272727272727
Dragon Age: Origins - Darkspawn Chronicles,15,37,58,110,0.4727272727272727
Robonauts,12,5,19,36,0.4722222222222222
Monopoly (2008),11,6,19,36,0.4722222222222222
Dragon Age: Origins - The Stone Prisoner,33,6,44,83,0.46987951807228917
She Sees Red,7,8,17,32,0.46875
Army of Two,79,25,118,222,0.46846846846846846
Super Exploding Zoo,8,14,25,47,0.46808510638297873
Spider-Man 3,87,37,141,265,0.4679245283018868
Ratchet & Clank Future: Quest for Booty,89,13,116,218,0.46788990825688076
Dragon Age: Origins - Golems of Amgarrak,24,34,66,124,0.46774193548387094
Mass Effect 2: Firewalker,20,22,48,90,0.4666666666666667
Twisted Metal: Small Brawl,9,5,16,30,0.4666666666666667
The Da Vinci Code,12,35,54,101,0.46534653465346537
Alien Shooter (2003),23,9,37,69,0.463768115942029
NFL Blitz 20-03,17,2,22,41,0.4634146341463415
Dragon Age: Origins - Warden's Keep,24,14,44,82,0.4634146341463415
Puzzle Agent,33,9,49,91,0.46153846153846156
Unmechanical: Extended Edition,18,6,28,52,0.46153846153846156
How to Survive: Storm Warning Edition,12,10,26,48,0.4583333333333333
Dragon Age: Origins - Leliana's Song,38,28,78,144,0.4583333333333333
Unreal II: The Awakening,37,11,57,105,0.45714285714285713
The First Templar,29,22,61,112,0.45535714285714285
Ben 10: Alien Force,14,5,23,42,0.4523809523809524
Touch the Dead,3,11,17,31,0.45161290322580644
kill.switch,11,3,17,31,0.45161290322580644
The Aquatic Adventure of the Last Human,11,3,17,31,0.45161290322580644
Hellgate: London,33,10,53,96,0.4479166666666667
Worms 3D,40,6,57,103,0.44660194174757284
DreamWorks Kung Fu Panda,35,5,50,90,0.4444444444444444
Turok,34,37,89,160,0.44375
Super Monkey Ball 3D,6,13,24,43,0.4418604651162791
Vietcong 2,11,7,23,41,0.43902439024390244
Worms: Open Warfare,17,1,23,41,0.43902439024390244
911 Operator,27,12,50,89,0.43820224719101125
Hulk,13,8,27,48,0.4375
Blazing Angels: Squadrons of WWII,10,4,18,32,0.4375
DRIV3R,16,38,70,124,0.43548387096774194
GoldenEye: Rogue Agent,15,5,26,46,0.43478260869565216
Dead Effect 2,13,7,27,47,0.425531914893617
Puzzle Agent 2,15,7,30,52,0.4230769230769231
Mario & Sonic at the Olympic Games,46,3,67,116,0.4224137931034483
Dragon Age: Origins - Return to Ostagar,39,13,72,124,0.41935483870967744
Sword of Fortress: The Onomuzim,1,22,32,55,0.41818181818181815
Tony Hawk's Project 8,21,11,45,77,0.4155844155844156
INDUSTRIA,9,5,21,35,0.4
Hexic HD,18,4,34,56,0.39285714285714285
We Were Here Too,12,2,22,36,0.3888888888888889
Rampage: Total Destruction,7,5,19,31,0.3870967741935484
Wii Play,34,16,80,130,0.38461538461538464
Alien Breed 2: Assault,11,19,49,79,0.379746835443038
State of Emergency,6,6,20,32,0.375
Alien Breed 3: Descent,5,14,32,51,0.37254901960784315
60 Seconds!,26,19,76,121,0.371900826446281
Mission: Impossible (1998),13,4,29,46,0.3695652173913043
Fortix 2,11,4,26,41,0.36585365853658536
Viscera Cleanup Detail: Shadow Warrior,9,3,21,33,0.36363636363636365
Shadow the Ronin - The Revenge to the Samurai,4,16,36,56,0.35714285714285715
"What Did I Do to Deserve This, My Lord!?",10,1,20,31,0.3548387096774194
Zombie Shooter,9,2,20,31,0.3548387096774194
Atelier Iris 3: Grand Phantasm,8,4,22,34,0.35294117647058826
Yurukill: The Calumniation Games,12,1,24,37,0.35135135135135137
Mario Hoops: 3 on 3,13,1,26,40,0.35
Crash: Mind Over Mutant,13,13,51,77,0.33766233766233766
The Walking Dead: Michonne - A Telltale Miniseries,59,30,184,273,0.326007326007326
FIFA Street 3,7,3,21,31,0.3225806451612903
Line Rider 2: Unbound,5,6,30,41,0.2682926829268293
Conflict: Global Terror,6,7,36,49,0.2653061224489796
Fantastic 4,27,14,117,158,0.25949367088607594
Fatal Inertia EX,7,5,38,50,0.24
Heroes Over Europe,13,9,71,93,0.23655913978494625
Faerie Solitaire,9,1,37,47,0.2127659574468085
Dark Void,7,17,117,141,0.1702127659574468
